abandon	放纵:constraint;放纵:unrestrainedly;放弃:withdraw;停止做某事:putanendto
abase	降低（地位、职位、威望或尊严）:lower
abash	使尴尬,使羞愧:self-confidence,embarrass
abate	减轻（程度或者强度）:reduce,degree,intensity;减少（数量）,降低（价值）:reduce,amount,value
abbreviate	v.缩写,缩短:briefer
abdicate	v.正式放弃（权力、责任）:throne
aberrant	adj.异常的,非常规的:deviating
abet	v.帮助,怂恿:assistorsupport;v.鼓励:encourage
abeyance	n.终止,搁置:inactivity
abhor	vt.深恶痛绝,极度厌恶:extremerepugnance
abiding	永久的:enduring
abject	adj.无精打采的:spiritless;adj.（地位、身份）悲惨、凄凉的:lowstate;adj.卑微的,讨好的:humble
abjure	v.发誓放弃:rejecting,abandoning;v.抵制避免:resist
abnegate	否认:deny,renounce;投降,放弃,交出（权力等）:surrender,relinquish
abominate	憎恶:abhor
aboveboard	无欺诈的,光明正大的:freefrom,deceitorduplicity
abrade	磨损,精神上的折磨:wearaway,byfriction
abridge	缩短,缩小:shorten;在不改变本意的条件下删减词语,缩写:shorten
abrogate	官方的正式废除:annul;无视（某事的）存在:nonexistent
abscond	偷偷离开:departsecretly
absolute	专制的:unconstrained;无限的unqualified;完美的,纯净不惨杂的:freefromimperfection,mixture;不容置疑的,确凿的:unquestionable
absolve	使无罪,解除责任:freefrom,guilt,exculpate
abstain	自我克制,主动戒绝:refrain,byone’sownchoice
abstemious	（吃喝等）有节制的,节俭的:restraint,foodoralcohol,sparing
abstract	做总结,概括:abstract,summarize;使分心:away,attention
abstruse	难以理解的:recondite
absurd	不合理的:unreasonable
abundant	大量的:greatplenty
abuse	辱骂,抨击:condemnorvilify;不正当的或不合理使用的:wrongorimproperuse;过分过量使用的:useexcessively
abut	邻接,毗邻:adjacent
abysmal	极低的,极可怜的:immeasurablylow;（程度）很深的,极端的:immeasurablygreat
accede	赞成:approval,consent;就任,就职:comeintoanoffice
accelerate	加速:faster;使提前发生:earlier;变大,变多:greater
accessible	可以达到的:withineasyreach;可以理解的:understood;能够获得的:get
accessory	辅助的,附属的:secondary,supplementary,subordinate;帮凶:one,wrongdoing
accidental	意外发生的,偶然的:unexpectedly;附带的,不重要的:notbeingavitalpart
acclimate	使适应:tochange(something)soastomakeitsuitable
accolade	同意,赞赏:approval;赞扬:praise
accommodate	提供所需（例如服务、借贷、寄宿）:provide;改变以适应新情况、新场景:make,suitable;使和谐:freeofconflicts
accost	以挑衅的形式搭讪:challengingoraggressiveway
accrete	逐渐增长:grow,gradually
accumulate	逐渐增长:increasegradually
acerbic	（心情、心境或者语调）尖酸的:wit,causehurtfeelings
acme	顶点,极点:highest;最佳典范:mostperfecttype
acquiesce	勉强同意;默许:accept,tacitlyorpassively
acrid	辛辣的,刺鼻的:harsh,taste,odor;刻薄的:wit,causehurtfeelings
acrimonious	刻薄的,充满仇恨的:deep-seatedresentment
acumen	不同寻常的洞察力和鉴别力:exceptionaldiscernmentandjudgment
acute	敏锐的:keendiscernment;严重的,急性的:immediateattention;（程度、影响）极强的:extreme
adamant	固执的,不可动摇的:unshakable,unyielding,inflexible
adapt	修改,使（适应）:modify
addict	沉溺,上瘾:surrender,obsessively;对某事上瘾的人:habitualliking
adhere	依附,粘着:stick;服从,遵守:accordingtothecommands;坚定地支持:steadfastsupport
adjourn	延期,休会:suspend;
adjunct	附属物,非必需部分:notessentiallyapart
ad-lib	即兴的:withoutpreviousthoughtorpreparation
admonish	建议:giveadvice;责备:reprovegently
adore	喜爱,因···感到愉悦:pleasure;宠爱:tenderness
adulate	极度谄媚:praisetoomuch
adulterate	掺杂,加入低等成分:impure,addition
adumbrate	部分地或有保留地揭露:disclose;预示着:giveaslightindication
adventitious	外来的,后天的,非内在的:notinherentorinnate
adversary	敌手,对手:resists,enemy
advert	引起注意,提到:refer
advocate	支持,提倡:support
affable	和蔼的,温和的:ease,friendliness
affinity	喜欢,倾向:attraction
affluent	富裕的:sufficient
aggrandize	增加、提高（力量、财富、地位、声誉）等:enhance
aggravate	加重,恶化:worse,serious,severe
aggregate	集合体:unitsorparts,associated;集合,聚焦:collectorgather
aggressive	好斗的:attack;强有力的,强烈的:forcefulness
aggrieve	使苦恼,使悲痛:pain,trouble,distress
agitate	煽动,激起:arouse;使不安:troublethemind,disturb
agog	极度感兴趣的:urgentdesireorinterest
agonize	（使）非常痛苦:deepsadness
airtight	无瑕疵的:no,flaw;密封的,不透气的:impermeabletoair
alacrity	反应迅速,乐意,欣然
alibi	不在场的证明,托辞,借口:excuse
alienate	疏远,离间:makeunfriendly;转移,变卖（财产或权利）:conveyortransfer
align	使排成一行:line;调准,校准:adjust
allay	减轻:subdue,reduce,intensityorseverity
allegiance	忠诚:devotionorloyalty
alleviate	缓和,减轻:relieve,lessen
allude	间接提到:indirectly
allure	吸引:attractordelight;诱惑做（某事）lead,pleasureoradvantage
ally	盟友,支持者:association;加入联盟:enter
aloft	在空中:inflight
aloof	孤高的,不合群的:distant
altruism	利他主义:unselfish
amalgamate	合并,混合:combine,unified,unite
ambiguous	有多种理解方式的,不确定的:morethanone,doubt,uncertain
amble	漫步,闲逛:walkslowly,leisurely,stroll
ambrosial	（食物）特别美味的,香的:extremelypleasing
ameliorate	改善,改进:becomebetter,improve
amenable     	顺从的,服从的:yield,submit
amenity     	（环境、设备等的）舒适,人性化:comfort;融洽,和谐:pleasant,agreeable
amiable     	好脾气,友好易相处的:friendly
amicable     	友善的:friendly,amiable
amity     	友好关系,亲善和睦:friendship,friendly
amorphous     	无固定形状的:definite,shapeless;不可归类的:unclassifiable
analgesic     	镇痛剂:medication,reduce,eliminatespain
anarchist     	反抗权威的人:rebelsagainstanyauthority
anathema     	诅咒:curse
ancillary     	次要的:secondaryimportance;辅助的,补充的:auxiliary,supplementary
anecdote     	短小有趣的故事:shortnarrative,interesting,amusing
anemic     	缺乏力量、活力、精神的:lackingforce
anesthetic     	止痛剂:relievespain;无感觉的,麻木的:lackingawarenessorsensitivity
animate     	活的:有活力的:life;使有活力,支持:high-spiritedenergy;使行动,驱使:action;使活灵活现,使栩栩如生:lifelikemovement
animus     	敌意:spiteful,malevolent,enmity
annoy     	不断烦扰:disturb,repeated
annul     	宣告无效,取消:legallyinvalid;抵消:balance,ineffective
anomalous	不普通的,不平常的:out,ordinary;反常的,不正常的:departing
anonymous    	匿名的:notnamed,identified;无特色的:lackingindividuality
antagonize      	与...敌对,反对:opposition,counteract;激怒:incur,provoke,hostility
antediluvian    	非常古老的,过时的:extremelyold,antiquated;保守的人:old-fashioned
anterior     	前面的:before
antic     	滑稽可笑的:clownish
apathy     	冷漠,缺乏情感:lack,feeling,emotion;缺乏兴趣,不关心:lack,interest,concern
aphorism     	格言,警句:shortwitty
apocalyptic     	预言的,启示的:prophetic;重要的,转折点的:majorturning
apocryphal      	假的:doubtfulauthenticity,spurious
apoplectic       	极度愤怒的:extremelyangry,furious
apostasy     	放弃宗教信仰:renunciation,faith;变节,背叛:abandonment,previousloyalty
appall      	使惊恐:consternation
appeal     	申请:application;起诉:charge,crime,accuse
appealing   	吸引人的:attractive,inviting
applause     	鼓掌,认可:approval
apposite     	相关的,合适的:pertinent,appropriate
appreciable     	可感知的,明显的:perceptible
apprehension     	忧虑,恐惧:suspicion,fear;逮捕:arrestment;理解:understand
apprise      	通知,告知:inform
approbation     	同意:approval
appropriate     	私自挪用:takepossession,withoutpermission;适当的:suitable,fitting
apropos     	相关的:relevant;关于,有关:havingtodowith
apt     	恰当的,合适的:suitable,appropriate;有倾向的,可能的:tendency,likely;聪明的:intelligent,responsive
archaic     	过时的,久远的:no,current,antiquated
archetype     	典范,榜样:ideal;先驱,鼻祖:earlier;原型:copies
ardor     	狂热:strongenthusiasm,devotion,zeal
arduous     	难以做到的,费劲的:difficult
argot     	隐语,黑话,行话:specialized,particular
arrest      	使不活跃:inactive;停止:stopping,standstill;逮捕:keep;吸引（某人）注意力:hold,attention
arresting   	吸引人的:attracting,striking
arrhythmic     	不规律的:lacking,regularity
arrogance     	傲慢,自大:overbearingpride
articulate     	清晰地表达:clearly,distinctly;表达清晰的:able,express,clearly
ascendant     	有影响力的,主宰的:dominant,influence,superior;上升的:upward,rising
ascetic     	苦行的,克己的,禁欲的:self-denial;禁欲者:person,self-discipline
aseptic      	消毒的,无菌的:preventinginfection;缺乏活力的:lackingvitality;冷漠的:lackingemotion
askew     	不成直线的（地）,歪的（地）:awry
aspect     	外表,容貌:appearance
asperity     	（举止、性情）粗暴:roughness;（环境）艰苦:rigor,severity
aspersion     	诽谤,中伤:harm,reputation
aspirant     	有抱负者,有野心者:aspires;想成为···的:seeking
assent   	同意:agree
assert     	断言,肯定地说出:declare,forcefully,aggressively
assertive   	自信的:bold,assertion,self-assured
assess     	评估（重要性、尺寸、价值等）:determine;征收费用（如罚款）:charge,penalty
assiduous     	勤勉的,专心仔细的:careful
assuage        	缓和,减轻:lessen,intensity;平息,抚慰:pacify,calm;使满足:satisfying
astounding     	令人吃惊的,出乎意料的:astonishment,amazement
astute     	机敏的,有洞察力的:shrewdness,perspicacity
asunder    	分离成多部分或多片地:separateparts,pieces;分离地:apart
asylum      	收容所,保护所:refuge,protection
asymmetrical     	不平衡的,不对称的:nobalance,symmetry
atone     	赎罪,弥补:amends
atrocious     	极坏的,极其残忍的:extremelywicked;让人极为不满的:extremelyunsatisfactory
attenuate	降低（数量、力量、价值）:lessen
audacious	大胆的,（但往往）愚勇的:fearlessly,recklessly;蔑视（法律、礼节）的,无礼的:contemptuousoflaw;乐于冒险的:takerisks;大胆创新的:verve
augur	预言家:predicts;出现好兆头:signsof,successfuloutcome;预言:tell,beforehand
authentic	真实的,非仿造的:exactly;准确的,相符的:original
authority	（某领域的）权威人士:ahighlevelofknowledge;管辖权,控制:lawfulcontrol;影响力:powertodirect;（管束他人的）权力:right,controlothers;根据,理由:warrant
autocracy	独裁政府:government,unlimitedpower
autonomy	政治上的独立:self-governing;自我主导的自由,（尤其是）精神独立:independence
avarice	贪财,贪婪:insatiable
aver	声称为真:state,forcefully;（态度强硬而明确地）声明:stateclearly
aversion	非常讨厌,极厌恶:dislike;令人厌恶的事物:someonethatishated
avid	急切渴望的:enthusiasm;贪婪（钱财）的:eager,formaterialpossessions
awash	被淹没的:bywater;（如洪水般）泛滥的:filled,covered,overrun
awe	敬畏:dread,veneration,wonder
awkward	缺乏灵活性和技巧的:lackingdexterity;（处理问题）缺乏手段和智谋的:alackofskillandtact;臃肿笨拙的,不优雅的:lackingease;令人尴尬的:embarrassment;（因过大或过重设计问题）难以操作的:difficulttouse
awning	雨篷,遮阳篷:shelter
awry	弯曲的,扭曲的:turned,twisted;走样的（地）,出差错的（地）:off,course
axiomatic	公理的:axiom;不言自明的:self-evident
babble	发出含糊无意义的嘟囔声,胡乱说:utter,meaningless;闲聊:ramblingconversation
backhanded	间接的,含沙射影的,虚情假意的:indirect
badger	不断纠缠或骚扰:harass,persistently
badinage	打趣,善意的玩笑:banter
bait	逗弄,激怒:persecute,exasperate;引诱:leadaway;诱饵:something,luring
bale	痛苦,悲哀:sorrow
baleful	有害的:harmful;凶兆的,凶恶的:evil;致命的:causingdeath
balk	阻碍:check,obstacle;不愿接受,拒绝:unwillingness
balky	不服管束的,倔强的:refusing
ballad	（由简单诗节和叠句组成的）民歌:poem
balloon	迅速增加:increase
balm	香油,止痛膏,安慰物:sweet-smellingoil,soothe;香气:pleasantsmell
banal	非原创的,陈腐的:trite
bane	祸根:ruin;有害物质:killorinjurealivingthing
banish	驱逐出境:leave,country;赶出:forceout
banter	幽默、打趣的（地）谈话:humored
barb	尖锐而严厉的批评:critical
barbarous	野蛮的,凶残的:mercilessly;未开化的:uncivilized
barefaced	公然的,厚颜无耻的:brazen
bargain	协议:agreement;讨价还价:negotiate
baroque	装饰华丽的,过分雕琢的,复杂的:extravagance,complexity,flamboyance;（程度上）过分的:beyond,limit
barrage	弹幕:curtain;有压倒之势的、集中倾泻的（如言语）:overwhelming,outpouring;（同时）袭来:attackwith,overwhelmingoutpouring
barren	不育的:incapable,producing;不产生结果的,无效的:noresults;贫瘠的:deficient;极度匮乏的:lacking
barricade	障碍物:obstruction,rampart;用障碍物阻止通过:preventaccess
barter	以物换物:trade,without
batch	一批次的量:unit;一小群人:smallnumberofpersons
bathetic	平凡的,陈腐的:commonplaceness
bawdy	下流的,猥亵的:indecent
bedeck	装饰,点缀:makemoreattractive
belabor	（当众）严厉批评:criticize;就···作过度的说明,喋喋不休:explain,excessively
beleaguer	包围,围攻:tosurround;使困扰,使烦恼,使消沉:trouble
belie	错误的描述,误述:picturefalsely;证明···为假:false,wrong;掩饰:shutofffromview;与···相对立,与···相矛盾:counter
bellwether	领导者,带头人:lead
beneficent	仁慈的,好慈善的:charity;（对个人或社会）有益的:contributing
benign	好心的,仁慈的:kindness,gentleness;无害的:notcausing
berate	（长时间）严厉指责:scold,vehemently,atlength
beseech	（急切地）恳求:beg
besmirch	弄脏,弄污:makedirty;诽谤,玷污:detractfromthehonor
bifurcate	（使）分成两支:twobranches
bigot	固执己见者,有偏见的人:obstinatelydevoted
bland	味道平淡的,不刺激的:soothing;无趣的:dull;温和的,和蔼的:notharsh
blandishment	甜言蜜语,讨某人好话:coax,cajole
blasé	（过度放纵之后）厌倦享乐的,腻厌的:apathetic
blast	爆炸:explosion;一阵猛烈的强风:gust;巨响:loud,sound;炸裂,爆破:causetobreakopen;斥责,抨击:criticizeharshly
blatant	大声喧哗的:noisy;（让人生厌地）惹人注目的:noticeable
blazon	使知名:makeknownopenly;修饰,装扮:makemoreattractive
blemish	缺点,污点:imperfection;损害,玷污:reduce
blight	（使）枯萎:affect;损害:impair
bliss	极度快乐:ecstasy;极乐世界:placeofperfecthappiness
blithe	愉快高兴的:happylighthearted;无忧无虑的,漫不经心的:freedomfromworries
blueprint	蓝图,详细计划:architects’plans;事先计划:workout,inadvance
blunder	过失:error,mistake;在···方面犯了很愚蠢且通常很严重的错误,糟蹋:makeastupid,error;蹒跚:unsteadily
blunt	使变钝:lesssharp;减弱（力度等）:weakeninstrengthorfeeling;直率的:direct,brief
blur	（使）变得朦胧,（使）变得不清楚:vague;使不易理解:uncleartotheunderstanding
blurt	突然说出,冲动地说:abruptly
bluster	狂妄自大地大声说:loudlyarrogant;大声吹嘘,恐吓:loudly;喧闹的状态:noisy
boggle	（因为怀疑、恐惧）犹豫:hesitate;笨拙地做:unskillfulway
boisterous	喧嚷的,吵闹的:noisily
bolster	支撑（物）:providesupport;鼓励、使有精力:boost
bombast	夸大的言辞:pompous
bonhomie	温和,和蔼:geniality
boo	嘘（以表示不满或嘲笑）:contempt,scorn,disapproval
boon	恩惠,福利:benefit;喜欢集体活动的:enjoythecompanyofothers
boor	粗鲁的人,不敏感的人:rude
bootless	无用的:useless
bound	界限:beyondwhichapersonorthingcannotgo;给···设置界限:setlimits;投入的,坚定的:fullycommitted
boycott	联合抵制,拒绝参与:concertedrefusal
bracing	令人振奋的,给人带来活力的:givingstrength
brake	刹车:lessrapid
brash	愚勇的,鲁莽的:foolishlyadventurous;缺乏判断力的,不明智的:poorjudgment
brassy	厚脸皮的,不知羞耻的:rudeboldness;华而不实地炫耀:showy
bravado	假装勇敢:pretense;虚张声势:swaggering
bravura	优秀演技（的）:brilliant
brazen	蛮横大胆的,厚颜无耻的:contemptuousboldness;大胆自信地去面对或从事:boldself-assurance
breach	（对伦理、法律准则的）破坏:breaking,moralorlegalcode;违背:failtokeep
brevity	简短,简洁:shortness;精炼:fewwords
bribe	贿赂,收买:give,money
bridle	限制
brisk	充满生机的,有活力的:activity;（言辞或方式）尖刻辛辣的,刻薄的:keenorsharp
bristle	怒不可遏,咆哮:anger;供应充足,充满:copiously
brittle	易碎的,脆弱的,易坏的:broken;不热心的,不真心的:lackinginfriendliness
broach	开启,启封:open;提出讨论:present
bromide	陈词滥调:hackneyed
brook	忍受,容许:tolerate;小溪流:creek
browbeat	恐吓:intimidate
bruit	（未经证实地）散播（消息）:make,thesubjectofcommontalk
buck	阻止,反对:refuseassent;转移,交接:shiftpossession
budge	（使）改变立场或态度:alteraposition;停止抵抗,屈服:ceaseresistance
bulge	凸起:protuberant;比赛中的优势地位:morefavorablecondition;暴涨,突增,在数目或数量上突然而且是临时性的增加:sudden,usuallytemporaryincrease;充满:copiouslysupplied
bully	欺凌弱小者:intimidatingmanner;最好的,最棒的:best
bumptious	专横傲慢的,自以为是的:superiority
bungle	办遭,失败:workclumsily
buoy	使充满勇气和力量,使振作:courageorstrength
buoyant	有浮力的:floating;心情好的:goodmoodordisposition
burgeon	迅速成长扩大,蓬勃发展:grow,rapidly,flourish
burlesque	夸张滑稽地模仿以嘲弄他人的文学艺术作品,恶搞:makefunof
burnish	擦亮,磨光:makesmoothorglossy
buttress	扶墙:supporting,wallbuilding;为···提供支撑的证据或者信息:provideevidenceorinformationfor
byzantine	错综复杂的:complicated,secretive,interrelated
cache	囤货,藏货:supply;隐藏:hiding
cachet	同意:approval;声望:prestige
cacophony	刺耳的声音:inharmonioussound
cadge	乞讨,乞求:beg
cajole	哄骗:wheedle
calcify	使僵化:inflexible,unchangeable
calibrate	调整,使标准化:standardize;（根据标准）精确测量:measureprecisely
calligraphy	（优美的）书法:eleganthandwriting
callous	无同情心的,冷漠的:unfeeling
callow	不老练的,不成熟的:lacking,experience
calumniate	诽谤,造谣,中伤:falsestatements
camaraderie	友情:friendly
cameo	栩栩如生的描绘,简洁生动的描述或刻画:brief,vividportrayal;客串:briefbutdramaticappearance
camouflage	伪装,伪装手段:deceive,hide
canard	谣传,误传:misleading
candor	坦率,直率,诚挚:honest,sincere
canon	准则,标准:standard,criterion;真经,正典:authentic
canvass	仔细检查,详尽讨论:examinecarefullyordiscussthoroughly;游说,去（一个地区）的各处或找到（个人）来拉选票或订单:solicitsvotesororders
capitulate	投降,默许:giveallresistance
caprice	一时冲动的决定:impulsivechange;反复无常,善变:change,impulsively
captivate	吸引:attract
careworn	忧心忡忡的,焦虑的:grief,anxiety
cardinal	主要的,非常重要的:foremostimportance,paramount
caricature	用讽刺歪曲等手法的夸张,漫画,讽刺画:exaggeration;嘲笑性模仿或夸张:copy,exaggerate
carnal	肉体的,物质的:physical;世俗的:worldly
carouse	畅饮,狂欢作乐:drink,freely
carp	对小事吹毛求疵,挑剔,表现不满:peevishcriticism,objections,expressdissatisfaction,tiresomely
carve	雕刻:three-dimensionalrepresentation;（通过长期不懈努力）开创,开拓:produceorbringabout
cast	演员,演员阵容:asetofcharacters;选派（演员）:assign,actor;提出:giveoff;抛弃:getridof
castigate	强烈（公开）指责:criticize;惩罚:penalty
catalyze	成为···的导火索,导致:bethecauseof
catastrophe	大灾难:tragedy;彻底的失败:utterfailure
categorical	没有例外的,无条件限制的,绝对的:without,qualification,absolute
catholic	普遍的,包容的:notlimitedorspecialized
caustic	腐蚀性的:destroying,eatingaway;挖苦讽刺的,刻薄的:incisivesarcasm
caveat	警告,告诫:warningofaspecificlimitation
cavil	挑剔,吹毛求疵:quibble
cavort	欢快地蹦跳或行走,雀跃:sprightly
cede	（根据条约）放弃,割让:surrenderpossessionof
cement	粘合,粘合剂:uniting,binding
censor	审查并删除不良的东西:examine,delete
censorious	挑剔指责的:critical
censure	公开表示反对,谴责:public,formaldisapproval
census	人口普查:survey,population
cessation	终止,暂停:stoppingofaprocess
chaff	开玩笑:makejokes
chagrin	沮丧,懊恼:mind
chameleon	变色龙,善变的人:changesoradoptsopinions
champion	支持:support
chaos	混乱:disorder,confusion
charade	装模作样:intendedtodeceive;动作字谜:representedinpantomime
charlatan	骗子,装懂的人:fraudulent
chary	非常谨慎的:cautious
chase	镂雕（金属）以装饰:decorate;驱赶:forceout
chasm	分歧,（意见、利益或忠诚上）明显差异:pronounceddifference
chauvinistic	盲目爱国的:excessivefavoritism
check	使突然停止,阻止:arrest,abruptly;同意,一致:agreement
cherubic	天使般可爱的:rosy
chicanery	诡计多端的,欺骗:deception
chide	责备:scoldmildly
choleric	易怒的,暴躁的:angered;生气的:anger,irate
chord	与···和谐一致,符合:accord,agree
chromatic	彩色的:colors
chronic	经常发生的,复发的:frequentrecurrence;习惯性的,不可能改变的:notlikely,change
churl	粗野的人:rude,boorish;吝啬鬼:mean,stingy
cipher	无影响或无价值的人:noimportance,influence;计算（价值）:determine,mathematicaloperations;密码:conceal
circuitous	迂回的,不直接的:not,forthright,direct;冗长的:more,necessary
circumlocution	绕圈子说话:unnecessarily,indirect,evasion;冗长:toomany
circumscribe	限制:limit;包围,围绕:surround
circumspect	谨慎的,小心的:careful
circumvent	躲避,不遵从:avoid,comply
civility	彬彬有礼:courteous,politeness
claim	要求（权利）:askfor,right;断言:stateasafact;剥夺生命:deprive,life;权利:right
clandestine	隐藏的,秘密的:secret,illicit,improper
clarion	清楚响亮的:loud,clear
clarity	清晰,清楚:clear,lucidity;清澈透明:easilyseenthrough
clasp	紧握:holding
clement	宽容的,善良的:tolerant,kind;气候温和的:neither,high,low
cliché	陈词滥调（的）:hackneyed
clog	阻碍物:something,movement,progressdifficult;阻碍:difficulty;堵塞:prevent,through
clot	密集的一群:anumberofthings,aunit;堵塞:prevent,through,fillingwithsomething;凝结:jelly
cloudburst	突然的一场暴雨:suddencopiousrainfall
clout	权力,影响力:influence
cloying	甜得发腻的,感情用事的:sweet,sentimental
clumsy	笨拙的:lacking,nimbleness,lack,skill;不文雅的:lacking,grace,inability,graceful;不精致的:roughly
coagulate	（使）凝结,（使）变稠:coherent,clot
coalesce	合并,融合:whole,fuse
coax	哄骗:pleading,flattery,cajole
coda	终曲:concludingpassage
coerce	（以武力）强制:force,threat
coeval	同时代的,同龄的:equalage
cogent	令人信服的:convincing;相关的:pertinent
cognizant	知道的,意识到的:aware
collapse	突然倒塌或收缩:fall,shrink;完全耗尽体力:depletion,energy,strength;失败:unsuccessful
collude	串通,共谋（做坏事）:togethersecretly,fraudulent,deceitful,conspire
colossal	巨大的:size,degree,immense
coltish	不守纪律的:notsubjected,discipline;爱开玩笑的:joking,teasing
coma	昏迷,深度无知觉:profoundunconsciousness;迟钝,冷漠:sluggishness
combustible	可燃的:igniting;容易激动的:easilyexcited
comely	漂亮的,吸引人的:pleasing,wholesome,attractive
comity	友好,社会和谐:friendly,harmony
commencement	开始:beginning;毕业典礼:conferring
commend	赞扬:approbation,praise;委托保管:entrust;推荐:recommend
commensurate	同样大小的:equal;相称的,相当的:proportionate
commingle	充分混合:blend
commitment	致力,投入:obligated,impelled;确信:belief;承诺,表态:revealingone’sview
committed	忠诚的,忠实的:loyal
commodious	宽敞舒适的:spacious
commonsensical	符合常识的,有依据的:commonsense,sound
commotion	骚乱:disturbance
compendium	摘要:summary,abstract;目录,各种各样的列表或集合:list,collection
complacency	自满,无忧患意识:self-satisfaction,unawarenessoftrouble
complaisance	愿意顺从,讨好,彬彬有礼:comply,affability
compliant	顺从的:submissive
compliment	称赞,恭维:praise;敬意,免费赠送的礼物:respectful
comply	遵从:conform,submit
compose	使镇定:calm;组成,构成:form,constitute
compound	混合物:somethingcomposed;混合的:consisting;混合:together;扩大,增多:greater;和解:agree
compress	压缩（体积）:reducesize,volume
compromise	妥协:concessions;使危险:danger
compunction	焦虑,内疚,良心不安:anxiety,guilt
concatenate	连结,混合:bringtogether
concave	凹的:curved
conceal	隐藏,隐瞒:preventdisclosure
concede	承认:grant;停止抵抗:ceaseresistance
concentrate	集中:focus;浓缩:lessdilute;聚集:together
concerted	共同完成的:accomplishedtogether
conciliate	平息,抚慰:lessentheanger;调解:compatible,reconcile
concise	简洁的:brevity
concord	一致,和睦:harmony,agreement
concur	同意:agreement;同一时间发生、存在:sametime;团结合作:joint
condescending	摆出高人一等的姿态的:patronizinglysuperior
condign	应得的,恰当的:deserved
condole	表达同情:sympathetic
condone	宽恕;忽视:forgive
conducive	有益的,有促进作用的:promote
confident	有信心的,自信的:assurance,self-reliance
confine	禁闭,监禁:imprison;限制:limits
confluence	汇合,混合:togethersame
confront	直接对抗,直面:facetoface
confound	使困惑:uncertainty;无法区分,混淆:failtodifferentiate;证明为假,证伪:false
congeal	凝固,固化:solidstate
congenial	和善的,友好的:agreement;令人愉悦的:givingpleasure
congruent	和谐一致的:inagreement;全等的:coinciding
conjecture	揣测的结果:conclusionbysurmise;猜测,估计（大小、数量等）:decidewithoutactualmeasurement;（没有依据地）认为:formanopinion
connive	暗中合作,共谋:cooperatesecretly;纵容:假装忽视或并未采取措施阻止错误:pretendignoranceoughttooppose
connoisseur	鉴赏家（尤指艺术领域）:withdiscrimination,appreciation;专家:highlevelofknowledge
conscientious	仔细的,一丝不苟的:involvinggreatcare;有良心的,正直的:governedbyconscience
consensus	一致同意:generalagreement
consequence	结果:producedbycause;重要性,价值:importance
conservative	守旧的,不愿改变的:opposechange;不招摇的,低调的:notshowy;谨慎小心的:closeattentiveness
conservatory	温室:greenhouse;艺术学院:schoolarts
conserve	保存,避免浪费:keepavoidwasteful
considerable	（数量上）可观（而值得注意）的:large;值得考虑的,重要的:significant
console	安慰,慰藉:alleviate,comfort
consolidate	使联合,统一:jointogether;加固,使安全:makefirm
consonant	和谐一致的:inagreement
conspicuous	显而易见的;吸引人的:obvious
conspire	合谋,密谋:plansecretly
constitute	指派,任命:appoint;构成:makeup
constrain	限制:restriction;使人屈服于（压力、感情）等:giveintopressure
constringe	使紧缩:drawtogether
construct	建造,建立:form;创造,相出:createimagination
consummate	专业的,有造诣的:extremelyskilled;无纰漏的,完美的:perfect;最高档次的,最大规模的:highestdegree
contagious	传染的:communicate;（情绪等）唤起共鸣的:excitingasimilarfeeling
contaminate	污染,感染:stain
content	使满足:appease;主题:majorsubjectofinterest;内容,内涵:ideathatisconveyed
contentious	引起争论的:argumentative;好争论的,好战的:tendencyquarrels
contiguous	接壤的,相邻的:sharinganedge
contort	扭曲:twist
contract	契约,合同:bindingagreement;收缩:reducesize;感染疾病:becomeaffected
contravene	违反,反对:violate,oppose
contrite	（因为有罪孽或过错而感到）后悔悲痛的:showingremorse
contumacious	不服从的,倔强的:disobedient
conundrum	无法解决的问题,迷:insoluble,dilemma
convalesce	渐渐康复,渐愈:recovergradually
convenience	便利,方便:fitnesssuitability
convention	常规,习俗:agreement,acceptance;公约,协议:agreement;大会,集会:comingtogether
converge	汇集,交汇于一点:movetowardone
conversant	熟悉的:familiar
convert	被改变宗教信仰的人:converted;使改变信仰:bringoverfrombrief;改变,转化:alter
convex	凸起的:curvesoutward
convey	运输:transport;传递,交流:communicate
conviction	深信,确信:beingconvinced;证明有罪:provedguilty
convoke	召集开会:bringtogether
convoluted	复杂的,费解的:complicated
convulsion	痉挛（强烈的、无法控制的肌肉收缩）:involuntarycontraction;骚乱:disturbance
coop	监禁,困于…之中:confine
copious	丰富的,大量的:abundant
coquette	调情的女子:flirt;调情,不认真对待:playfully
cordon	警戒线:linepreventing;围成一道防线:formcordon
cornucopia	大量:overflowing
coronation	加冕,加冕礼:crowning
corporeal	肉体的:notspiritual;有形的,实体的:notimmaterial
corroborate	用证据或权威证实:supportwithevidence;为…提供证据,支持:provideevidence
corrosive	腐蚀性的:destroyslowly;讽刺性的:sarcastic;
corrugated	褶皱的:folds
cosmopolitan	有世界性眼光的,包容的:worldwide
cosset	宠爱:pamper
countenance	容忍:putupwith;赞成,推崇:favorableopinion;沉着,冷静:evenness
counterfeit	仿制的,假冒的:imitation;仿制:fraudulentreplica;伪装成:falseappearance
countermand	取消,撤销:revoke
court	追求,献殷勤:seekaffections
covert	隐蔽的,秘密的:notshown;隐秘庇护所:avoidothers
covetous	贪婪的,渴求财富的:inordinatedesire
cow	恐吓,威胁:frighten
cowardice	懦弱,不坚定:lackcourage
cower	畏缩:cringe
cozen	诱骗:mislead
cramped	狭小的,狭窄的:small
crass	粗俗的,愚钝的:unrefined
crave	热望:intensedesire
craven	非常懦弱的,因胆小而遭人鄙视的:lackingcourage
crease	折痕:folding
credence	坚信:firmbrief
credulous	轻信的,易受骗的:gullible
creek	小溪,小河:smaller
creep	缓慢地行进:slowly;匍匐前进:bodyclosetotheground
crescendo	（声音）渐强:gradualincrease;（渐强之后到达的）顶峰:peak
crest	顶部,浪尖,山顶
crestfallen	垂头丧气的,沮丧的:depressed
cronyism	任人唯亲的,对好朋友的偏袒:favoritismfriends
crook	使弯曲:awayfromastraightline
croon	低声歌唱或说话:murmuring
crouch	蹲伏:lowerstance
crucial	非常重要的,决定性的:extremelysignificant
crumple	弄皱:bend;（因外力挤压而）垮塌:falldown
crutch	支撑,支柱:supports
crux	中点,关键点:criticalpoint
cryptic	秘密的:secret;含义模糊的:ambiguousmeaning;超出理解能力的:beyondone’spowerstoknow
culpable	该受谴责的,有罪的:deservingblame
cultivate	提升,加强:improve;种植,培养:promotegrowth
cumbersome	笨重的,难处理的:difficulttohandle
cunning	狡猾的:artfuldeceptiveness;（手工）灵巧的:skillful;欺诈,欺骗:practiceofmisleading
curmudgeon	脾气坏的、爱抱怨的人:irritableandcomplaining
cursory	匆忙的,不注意细节的:excessiveorcarelessspeed
curt	言词简略的,直接（以至显得粗鲁）的:direct,brief,andpotentiallyrude;言简意赅的:conveymuchinformation
curtail	缩短,削减:lessinextentorduration
cynic	愤世嫉俗者:selfishness
dabble	涉猎,对…浅尝辄止:superficially
daft	神经错乱的:abnormal,sickstateofmind;不明智的:lackofgoodsenseorjudgment
dais	主席台,嘉宾席:raisedplatform
dally	虚度时光:doingnothing;玩乐:amusement;慢吞吞,磨磨蹭蹭:slowly
damper	抑制因素:restrains,depresses
dandy	纨绔子弟,爱打扮的人:appearance;最佳的,最好的:verybestkind
dank	阴湿的:wet
dapper	衣冠整洁的:strikinglyneatandtrim
dappled	有斑点的,花的:markedwithsmallspots,mottled,spotted;色彩斑斓的:twoormorecolors
daredevil	大胆鲁莽的（人）:foolishly;不考虑后果的:alackofconcernfortheconsequence
dart	突然移动,猛冲,狂奔:suddenly;公开侮辱:intendedtohurtanother’sfeelings
daunt	使胆怯,吓到:tolessenthecourage
dawdle	闲荡,虚度光阴:spendtimeidly;拖拖拉拉:slowly
deadpan	无趣的,无生气的,不活泼的:impassively
dearth	供应不足:inadequate
debacle	溃败:completefailure
debark	（使）下船（飞机、车等）;卸（客、货）:unload,fromashiporanairplane
debase	贬低,贬损:lowerstanding
debilitate	使衰弱:impairstrength
debris	废墟:discarded,uselessmaterial
debunk	揭穿…的真面目:truenature;证明…为假:false
debut	初次登台,出道:firstappearance
decadence	衰落,颓废:deterioration,decline
decant	轻轻倒出:pouroffwithoutdisturbing
decipher	破译:interpret;对…有清晰的想法,理解,解读:clearidea
decode	解码:changeintoordinarylanguage;对…有清晰的想法,理解,解读:clearidea
decorum	礼仪,得体:appropriateness,propriety
decrepit	虚弱的,衰老的,破旧的:weakened
default	不履行义务,玩忽职守:nonperformance
defer	推迟,延期:postpone;遵从:respect
deference	尊崇,顺从:yieldto
deficiency	缺乏,不足:inadequate
defile	（山间）小道:anarrowpassage;亵渎:treatwithgreatdisrespect;使腐坏,污损:makeunfitforuse
deft	灵巧的,熟练的:skill
defuse	抚慰,减轻:makelesstense
defy	反抗,违抗:goagainst
dehydrate	去除水分,使干燥:removewater;使失去活力:depriveofvitality
deify	把…当作神来崇拜:offerhonororrespectto;过分喜爱:loveoradmire;尊敬,尊崇:highstatusorvalueto
deject	使沮丧:lowerthespirits,dishearten
deleterious	有害的:harmful
deliberate	深思熟虑的:careful
delicacy	（外貌、结构等）精致,极度兴奋,发狂:fineness
delirium	精神错乱;极度兴奋,发狂:mentaldisturbanceconfused
delusion	错觉,妄想:false
deluge	大暴雨:drenchingrain;大量:greatflow
delve	探究,钻研:detailedsearchforinformation
demagogue	蛊惑民心的政客:leaderfalseclaims
demanding	难以取悦的,难满足的:satisfied;费时间花心思的:requiringcarefulattention
demolition	破坏,毁坏:destroying
demonstrate	（通过证据）证明,表明:makeclearusingexamples;使明白易懂:makeplainorunderstandable;表现,表露:makeknown
demoralize	使士气低落:dishearten;贬低,使堕落:lowerincharacter
demotic	通俗的,大众化的:common
demur	表示异议,反对:opposition,objection;犹豫:doubtacceptabilityqualm
denigrate	诋毁,污蔑:scornfully
denouement	（小说的）结局:finalresolution
denounce	公开指责:publicorformaldisapproval;宣称…道德上错误、可耻:morallywrong
dent	凹陷,凹痕:depression;（数量,程度上）削弱:makesmaller
denude	脱去,使赤裸:bare
deplete	耗尽,使衰竭:makecompleteuse
deplore	哀悼:sorrow
deploy	（有目的地）展开;调度,部署:spreadout
deportation	放逐:removalfromacountry
depose	宣誓作证:testify;废黜,罢免:removefromathrone;摆放:arrange
deposit	自然积累,沉积,矿藏:accumulation;存钱:putinaccount
depravity	道德败坏:immoral,harmfuloroffensive
deprecate	不喜欢:unfavorableopinion;贬低,轻视:expressscornfully;降低…的重要性,使低调:playdown
depreciate	贬低…的价值:lowervalue;轻视:lowerestimation,esteem
depressed	不开心的,情绪不高的,消沉的:unhappiness;生活境况悲催的:healthfulenvironment
deprivation	匮乏:privation
deracinate	根除:pullout
derelict	玩忽职守的,不认真的:lackingduty,carelessly;被社会遗弃的人:socialmisfit
deride	嘲弄,嘲笑:contemptuousmirth
derivative	非原创的:originality
descend	下降:downward;世代相传:passbyinheritance
descendant	后代:derivingdirectlyfrom
desecrate	亵渎,玷污:treatshamefully
desiccate	使（食物）脱水以保存,使干燥:drying;使缺乏活力:deprivevitality
designate	任命:topickforaspecificpositionorduty;命名:giveanameto
despicable	令人鄙视的:loathinganddisgust;不荣耀的,不得体的:nothonor
despise	极其不喜欢的:dislikestrongly
despotic	专制的,暴虐的:tyrannical
desultory	无计划的,无目的的:lackingplan;令人失望的:disappointing
detach	使分离:separate
detain	拘留,扣留:hold,keep
deter	吓住,威慑:prevent,discourage
deterioration	恶化,堕落:sinking
detour	偏离正常标准:awayfromstandard;改变方向或者路线,绕道:changedirection
detract	贬低,降低价值:diminish;使分心:drawattention
detritus	废品,碎屑,遗骸:productdisintegration,destruction,debris
devoted	投入的,忠诚的:loyalty,devotion;示爱的,恩爱的:love
devout	（对于宗教）虔诚的:devotedtoreligion;忠诚的:allegiance
dexterous	动作灵活的:ready,skilled;头脑灵活的:mentallyadroit,skillful
diabolic	恶魔一般的:devil
diaphanous	模糊的;非实在的:vagueinsubstantial;（质地精致得）几乎透明的:transparent,translucent
diatribe	长篇抨击性演讲:longscolding;挖苦,讽刺的指责:ironic,satirical
didactic	喜欢说教的:teach
diehard	顽固的,保守的／顽固的人,保守的人:determined,devoted/opposeschange,refusesnewideas
diffident	不自信的:lackself-confidence;内向的:reserved
diffuse	啰嗦的:verbose;不集中的,扩散的:notconcentrated;扩展,散开:extend,scatter
digress	脱离主题:turnasidemainsubject
dilapidate	（使）荒废:ruin
dilate	（使）膨胀,扩大:enlarge,expand,wide;详细表达:morefullygreaterdetail
dilatory	拖延的,磨蹭的:causedelayprocrastination
dilettante	业余爱好者（对艺术或知识领域涉猎浅薄者）／缺乏专业技术的:superficialinterest/lackingexpertskill
diligent	勤勉的,辛勤的:steady,earnest,energetic
dilute	稀释／经稀释的:concentrated/lowstrength,concentration;削弱:diminishstrength,flavor,brilliance
diminish	（使）变小,（使）减少:smaller,less;轻视,贬低:lessen,belittle
din	喧闹声,嘈杂声:loudnoise;重复,使人厌烦地反复灌输:again
dingy	昏暗的;肮脏的:darkened,dirty
diocesan	主教管辖区的:diocese
diplomatic	使用策略的,机智的:tact
dire	不吉利的,不详的:calamity;可怕的,恐怖的:fear;迫切的:immediate,urgent;悲惨的:lackingcheer
dirge	挽歌:solemn,mournfulmusic
disabuse	打消错误念头,纠正:freefromerror,fallacy,misconception
disaffected	不满的,叛逆的:discontented
disarm	解除武装:reducearmedforces;使息怒,平息,抚慰:lessen;使无害:harmless
disarray	混乱,无秩序:lackorder;使混乱:undoorder,arrangement
disavow	拒绝承认,否认:disclaim
discern	识别,辨别差异:perceive,detect
discharge	解雇:dismiss;释放:free;不承担责任:freeingobligation,responsibility
disciple	信徒,追随者:follower
discombobulate	使不安,使混乱:upset,confuse
discomfit	使尴尬:embarrassment;阻碍:prevent
discommode	打扰,使不便:trouble
discompose	使不安:disturbcomposure,perturb;使混乱:undoorder,arrangement
disconcert	使不安:disturb
discord	意见不一致,不和谐:lackagreement,harmony
discredit	羞耻,使丧失名誉:damagereputation,disgrace;怀疑,不相信:nottrue,real
discrepancy	（在事实和宣称之间的）差异或矛盾:divergence,disagreement
discrete	离散的,不连续的:separate
discretion	谨慎:discreet,circumspection;自制,节制:checking
discretionary	自主决定的:one’sowndiscretion
discriminate	区分:perceivedistinguishing,recognize;歧视:difference
discursive	（谈话内容）杂乱的:withoutorder
disdain	轻视,鄙视:scorn
disengage	分开,使脱离:setfree,entanglement
disgorge	呕吐出:discharge,vomit;被迫放弃:giveup
disgruntle	使发怒,使不满意:discontented;使疏远,使不友好unfriendly
disguise	伪装（防止被认出）:preventrecognition;隐藏,掩饰:secretshutoff
disinclination	不喜欢,厌恶,不情愿:lackwillingness,desire
disinfect	消毒,使无菌:freefrominfection
disjointed	机能失调的:outorderlyfunction;不连贯的:notconnected
disinter	（从墓地里）掘出:takeout
disinterested	公正的,无偏见的:freefromselfish,unbiased;没有兴趣的:lackinterest,concern
disjunctive	分离的:breaksdisunity
dismantle	分解,分拆:pieces,destroyintegrity
dismay	使失去勇气:losecourage;使不安,使焦虑:trouble,uneasy
disparage	贬低;轻蔑地说:lower,disrespectful
disparate	迥然不同的:distinct,differentdissimilar
dispassionate	客观公正的,不易被情绪或偏见影响的:unaffected
dispatch	迅速:promptness;发送,派遣:oneplacetoanother;使死亡:deprivelife;获胜,胜过…:victory
dispose	使倾向于:tendencyincline;处理掉（与of连用,disposeof）:getridof,throwout;有序地布置:orderly
disregard	漠视,不关注:noattention;缺乏兴趣,缺乏关心:interestconcern
dissect	仔细分析:examine,analyzeminute;切成片（尤其是为了解剖研究）:cutapartseparate
dissemble	用假象隐藏真相,掩饰:false
disseminate	散播,传播:spread,promulgate
dissension	意见不合:difference,disagreement
dissent	持异议,不同意:differ;反对正统:departureaccepted;不和谐:lackharmony
dissipate	驱散:driveaway,disperse;浪费:wastefully,squander;放纵:indulge,intemperate
dissolute	放荡的,无节制的:restraint,indulging
dissolve	溶解融化:solution;解散:breakintoparts,disintegrate;驱散;（使）消失:ceasevisible;废除,撤销:end
dissonance	（音调）不和谐,刺身;不一致,分歧:disagreeable
dissuade	劝阻,反对:deterpersuasion,exhortation
distain	贬损,伤害（某人的）名誉:losehonor,respect,reputation;弄脏:dirty
distal	远离中心的,（神经）末梢的:situatedaway
distend	（使）膨胀:expand
distill	对…用蒸馏法提高纯度:increase,purify;（使）渗出;（使）滴下:falldrops
distort	扭曲,歪曲:twist
distract	转移（注意力）,使分心:draw,directdifferent;使焦虑,使不安:trouble,uneasy;疯狂的:insane,mad
distraught	精神狂乱的,极疯狂的:agitated,insane
diurnal	白天发生或行动的:daytime;每天的:everyday;期刊:publicationatregularintervals
diverge	改变方向:change;（使）分叉,散开:differentdirectionscentral;分歧:different,differ;离题:departfrom
diversity	多样性:variety,multiformity;分歧,不同点:different
divert	使转向:turn,deflect;使消遣:agreeably;使分心:drawsomethingelse
divestiture	剥夺:takingaway
divulge	泄露（秘密）:knownconfidence,secret
dodder	蹒跚,颤巍巍地行进:progressunsteadily
dodge	躲避:avoid
doff	脱下:takeoff,remove
dogged	坚持的,坚决的:continuing,slackening,yielding];固执的,任性的:stickingto
dogma	教条,信条:doctrinestatedauthoritatively
doldrums	低迷,中断:inactivity;情绪不佳:lowspirits
dolorous	忧伤的:misery,grief
dolt	笨蛋:stupid
domicile	住所,住宅:residence;为…提供住处:providedomicile
dominant	处于支配地位的:controllingothers;（基因）显性的:geneticdominance
don	穿上:puton
donor	捐赠人,给体:donates
doodle	（无目的）地乱涂乱画:aimlessly;漫无目的地打发时光:aimlessactivity
dormant	静止的,不活跃的:inactivity;（动物）冬眠的:suspended
dour	闷闷不乐的,死气沉沉的:gloomy;严厉的:harsh
douse	熄灭:putout;弄湿:wet
downplay	轻描淡写:,不予重视:minimizesignificance
downpour	倾盆大雨:heavyrain
doyen	有经验的人,资深人士:knowledgeexperience;（加入时间较长的）高级会员:seniormember
doze	小憩:lightly
draconian	极其残酷的,十分严厉的:harsh
drawl	慢吞吞地说:speakslowly
dreary	单调乏味的:nothingcheer;令人不悦的:causingunhappiness
drench	使湿透,浸透:wetthoroughly
drivel	胡言乱语:meaningless;胡言乱语,说傻话:talkstupidity
drizzle	（下）细小、轻柔、似雾的雨,毛毛雨:mistyrain
droll	古怪有趣的,离奇可笑的:amusinglyodd
drone	低沉单调地说;嗡嗡地叫:talkmonotonous;（昆虫振翅般）单调嗡嗡的声音:monotonoussound;混日子:doingnothing
drudgery	苦工;单调、卑贱或无趣的工作:tediouswork
dubious	充满不定性的,值得怀疑的:uncertainty,questionable;（对事实等）持怀疑态度的:notfeelingsure;迟疑不决的,不愿行动的:slowtobeginbecauseofdoubts
ductile	可塑的,有延展性的:malleable;易受影响的:easilyled
dulcet	悦耳的,令人愉悦的:melodious
dullard	笨蛋:stupid
dupe	复制品,复制:exactlylikesomethingelse;易受骗的人:easilydeceived;欺骗:deceive
duplicity	欺骗,口是心非:deceptiveness
dwindle	逐渐减少:graduallyless
dyspeptic	脾气坏的:bad-tempered;消化不良的:dyspepsia
earnest	严肃认真的:serious
earshot	听力所及的范围:rangehear
earsplitting	震耳欲聋的:distressinglyloud
eavesdrop	偷听:listensecretly
ebullient	热情奔放的:zestfully
eccentric	行为出格的,不循规蹈矩的:deviatingconventional
éclat	辉煌成就:success
eclipse	下降,衰退:lowerstate;使声望下降,使黯然失色:diminishimportance;（在数量、品质上）超越:begreater
ecstasy	无法自控的情绪:beyondself-control;狂喜:intensejoy
ecumenical	全球基督教会的:wholechurches;世界范围的,普遍性的:worldwide
edible	可食用的:eaten
edifice	大厦;大建筑物:massivestructure;基础,基本结构:basicform
efface	擦掉,抹去;使不明显:makeindistinct
effervesce	冒泡:bubble;兴奋,热情洋溢:highspirits
effete	衰弱的,衰落的:depleted;缺乏信念的,懦弱的:lackingstrengthofwill
effluvium	难闻的气味:offensivesmell;没有的副产品,废品:by-productwaste
effrontery	厚颜无耻,放肆大胆:disregard,courtesy
effulgent	光辉灿烂的:resplendent
effusive	感情泛滥的／溢于言表的;感情表达不节制的／过度的;过分多情的:unrestrainedinemotionalexpression
egalitarian	平等主义的:promotingequalrights
egoistic	利己的,以自我为中心的:centeredinoneself
elaborate	详细的,复杂的:complexity;详细阐述:indetail
elastic	有弹性的:resumingshape;能（迅速从伤痛中）恢复的:recoveringfromdepression
elate	使开心,使自豪:fillwithjoy
eleemosynary	慈善的:charity
elegy	哀歌（诗）,挽歌（诗）:expressingsorrow
elephantine	巨大的:enormoussize;笨拙的:clumsy
elevate	（在道德、智力、文化水平上）提升:improve;使兴奋:raisespirits
elicit	激起,唤起:bringout
elliptical	含糊不清的:obscurity;椭圆的:ellipse
elucidate	阐明:makelucid
emaciate	使消瘦,使衰弱:becomethin;削弱:feeble
emancipate	解放,解除束缚:free
embargo	贸易禁止令:prohibitiononcommerce
embark	上船:goabroad;开始从事:start
embarrass	使尴尬:experiencedistress;阻挠,制造障碍:createdifficulty
embed	嵌入:enclose
embezzle	盗用:appropriate
embolden	鼓励,使大胆:instillcourage
emboss	以浮雕效果妆点,装饰:ornamentwithraisedwork
embrace	乐于接受:willingly,eagerly;保围:surround
embroider	（时常伴有夸张和想象内容地）详细说明:giveelaborateaccount
emigrate	移民,移居海外:leave
eminent	杰出:aboveothers
emollient	起缓和作用的:lessintense
emulate	效仿并努力超越:excelthroughimitation
enact	制定或颁布（法律）:establish
enamel	涂亮漆;使具有光滑或亮泽的表面:giveaglossysurface;用亮丽的表面装饰:adorn
encomium	赞颂之词:praise
encompass	组成,包含:include;包围:envelop
encumber	阻碍,妨碍:impede;给…增添负担:placeburden
endemic	地方性的:toaparticularregion
endorse	公开支持,推崇:expressapproval
enervate	使衰弱:weaken;使麻木:depriveofemotionalvitality
enfranchise	给予…权力（例如选举权）:endowrights;解放:setfree
engender	引起,使发展:cause;产生,出现:comeintoexistence
engross	使全神贯注:occupyexclusively
enigma	难以理解或解释的事物,谜:hardtounderstand
enlighten	使知道,启发:inform,instruct;（在道德或精神上）进行教育:providemoralunderstanding
enmity	敌意:mutualhatred
ennoble	使尊贵:noble
ennui	倦怠;缺乏兴趣:listlessness,lackofinterest
ensemble	合唱,合奏曲:twoormovevocalists
ensconce	安置:settlesecurely;隐藏:hiding
ensue	紧随其后:afterward
entangle	使卷入,使纠缠:twistconfusedmass;使变复杂或困难:complexordifficult
enthusiasm	热情,兴趣:desireorinterest
entice	诱使:tempt,lure
entrance	进入权,进入许可:meansofenteringorparticipation;使入迷:wonder,enchantment
entrap	诱骗:lure
entreat	恳求:pleadpersuade,askurgently
enunciate	清晰地说:articulate;公开宣布,宣称:openlyorpublicity
ephemeral	短暂的:veryshorttime
epic	宏大的,超凡脱俗的:surpassingtheusual
epicure	美食家:discriminatingtastes
epigram	机智的短诗,警句:shortwitty
epilogue	文学作品的结局:concludingsectionliterary;戏剧的收场白:finalsceneofapaly
epithet	外号,绰号:descriptivename
epitomize	摘要,概括:shortstatement,mainpoints;代表,体现,是…的典型范例:representatypicalexampleof
equable	（脾气、性情）温和的:serene
equity	不偏不倚,公平:lackoffavoritism
equivalent	等价的,相等的:equal
equivocate	（带有欺骗目的地）模棱两可地说,说谎话:equivocal
erode	侵蚀,慢慢减少:consumegradually
errant	居无定所的:fromplacetoplace;误入歧途的,犯错误的:strayingpropercourseorstandards
erratic	善变的:notconstant;异常的,不同寻常的:differentfromtheordinary
erudite	博学的:learned
escalate	（使）（战争等）升级,扩大:increase
eschew	刻意避开;戒绝:avoid
esoteric	深奥难懂的:difficulttounderstand;少数人知道的:notknownbythegeneral
espouse	支持;拥护:support;与…结婚:marriage,marry
esteem	尊重:respect,prize
estimable	值得尊敬的:admirable
estrange	使疏远,离间,使感情失和:enmity,indifference,friendliness
etch	蚀刻;留下深刻印象,铭记:produceavividimpression
eternal	永恒的:infiniteduration,everlasting,perpetual
ethereal	轻巧精致的:lightness,highlyrefined,delicate;天国的:heaven;非物质的,精神（上）的:spiritual,notcomposedofmatter
ethics	道德规范:governingconduct
eulogize	称赞,颂扬:speakinhighpraiseof
euphemism	婉言,委婉的说法:inoffensiveexpression
euphonious	悦耳的:pleasing
euphoria	感觉极其愉快:overwhelmingusuallypleasurable
evacuate	撤空:emptyorremove;撤退:remove
evanescent	逐渐消失的,短暂的:vanish
evasive	难以发现,捕捉,分离的;含糊其辞的:equivocal
everlasting	永恒的,持久的:forever
evict	赶出,逐出:expel
evince	表明:makeknown
evoke	唤起,引发:callup
exacerbate	使加剧,使恶化:severe
exacting	严格的,苛求的:rigorous;费时间心思的:requiringtime,effort,attention
exalt	提升,提拔:raise;赞扬:praise
exasperate	激怒:excite
excavate	挖掘,挖空:digout
exceptional	例外的,特别的,非凡的:uncommon,extraordinary
excoriate	严厉批评:criticizeharshlypublicly
excrete	排泄:discharge
excruciate	折磨,使痛苦:pain
exculpate	声明无罪;开脱,使无罪:clearfaultguilt
excursive	离题的;散漫的:passing
execrate	谴责:morallywrongorevil;痛恨:dislikestrongly
exemplary	榜样的,值得效仿的:beingapattern,imitated;作为警告的:warning
exempt	使免除:releaseliability
exhaust	耗尽:consumeentirely,completeuseof;筋疲力尽:wearout
exhilarate	使高兴;使兴奋:cheerful,excited
exhort	敦促,力劝:urgestrong
exigent	紧急的:immediate
exodus	大批离去:departure
exonerate	免除责备:freefromblame
exorbitant	过度的:exceedingthecustomaryorappropriatelimits
exotic	外来的,不同寻常的:unusual
expansive	广阔的:greatexpanse;健谈的,外向的:open,talkative,effusive
expedite	加快进程:speeduptheprogress
expedition	动作迅速:speed
expiate	赎罪,纠正:extinguishtheguilt
expire	断气,死亡:die;到期:cometoanend
explicit	表达清晰的:fullyrevealedorexpressed;成熟的,完全形成的:fullydeveloped
exploit	英雄行为:notableact;最大程度地利用:employ
exponent	倡导者,支持者:advocates;实践者,典型代表:fullrealization
expurgate	净化（书等）,删去（不当处）:remove
exquisite	成都强烈的:extreme;精致精巧的:refinedtaste
extant	现存的:notdestroyed,extinct
extemporize	即兴表现:withoutpriorpreparation
extenuate	减轻罪过:lessentheseriousness
extinct	灭绝的:nolongerexisting
extinguish	熄灭:putout;终止:bringtoacompleteend
extol	赞美;吹捧:praise
extort	勒索:force,intimidation
extract	用力拔出:takeout
extraction	血统:origin,ancestry
extraneous	无关的:norelevance;非主要因素的:notessential
extravagant	挥霍的:spendingmoneyfreely;过度的,不必要的:beyondnormalacceptablelimit
extricate	使解脱,救出:freeentanglement
exuberant	非常高兴的,热情洋溢的:joyously,unrestrained;大量的,充分的:abundance
exude	分泌,流出:flowforth
exult	感到欢喜:rejoice
fable	寓言故事:storyteachabasictruth;神话,传说:storyofsupernaturalhappenings;谎言,虚构:statementinordertodeceive
fabricate	捏造:makeup;搭建,组建,打造:bringintobeingbycombining
facetious	喜欢开玩笑的,轻浮的:joking
facile	表面的,浅尝辄止的:lackofdepth;容易的,唾手可得的:easilyaccomplished
facilitate	使变容易,促进:makeeasy
faction	派系:apartythatisoftencontentious
fallacious	谬误的,不合逻辑的:containingfallacy;欺骗性的:tendingtodeceive
fallow	休耕的:untilled;闲置的:notbeinginastateofuse
fail-safe	保险措施:toprecludelossorinjury;万无一失的:nochanceoffailure
falsehood	谎言:untrue,madeinordertodeceive
falter	蹒跚:walkunsteadily;犹豫踌躇:unsteadyinpurposeoraction
fanatic	狂热者:unreasoningenthusiasm;狂热的;盲信的:intenseuncriticaldevotion
fantasy	幻想:imaginativefiction;产生幻想:formamentalpicture
farce	（带有嘲讽元素的）滑稽戏:broadlysatiricalcomedy;闹剧:ridiculous
fascinate	强烈吸引,使入迷:holdanintenseinterest
fast	绝食,斋戒:abstainingfromfood;快速的:quick;忠诚的:firminone’sallegiance;稳固的,难以拆卸的:firmlypositioned
fastidious	挑剔的,极仔细的,追求完美的:meticulousattentiontodetail
fateful	意义重大的:momentous;带来灾难的,毁灭性的:bringingdeath
fathom	测量（深度）:measurethedepth;彻底理解,弄懂:cometounderstand
fatigue	疲惫:wearinessorexhaustion;（让人厌倦的）苦差事:causesweariness
fatuous	愚笨的,昏庸的:foolish
faultfinder	吹毛求疵的人:pettycriticism
favorable	赞许的:expressingapproval;有利的:promote
fawn	阿谀奉承:seekfavorbyflattery
faze	打扰,使尴尬:disturbthecomposure
feckless	无成果的,没有价值的:havingnoworth;粗心不负责任的:careless
fecund	多产,肥沃的:fruitful
feeble	衰弱的:lackinginstrength
feign	制造假象,装出…的样子:giveafalseappearance
fender	缓存装置:cushioningdevice
feral	野生的:notdomesticated;动物性的:natureofaloweranimal
fertilize	使肥沃,使多产:makefertile
fervid	酷热的:hightemperature;热情的:greatpassion
fervor	热情,狂热:greatwarmth
fester	感染,溃烂,腐烂:corrupt
fetid	恶臭的:offensivesmell
fetter	枷锁,限制:limitsone’sfreedom;束缚:restrainfrommotion
fiasco	大失败:completefailure
fickle	易变的:likelytochange;不忠诚的:nottrueinone’sallegiance
fictitious	虚构的:notreal
fidelity	忠诚:beingfaithful
figurative	比喻的:denotinganother
figurine	小雕塑:smallstatue
filibuster	拖延议事:forthepurposeofdelayinglegislativeaction
filter	过滤:passthroughafilter;去除杂质:removeimpurities
finale	终场,结局:closingpart
finesse	娴熟技巧:skill;精心策划:planoutwithsubtleskill;（巧妙地）躲避:keepawayfrom
finicky	过分讲究的,挑剔的:extremelymeticulous
flaccid	不结实的,松弛的:lackingfirmness
flag	旗帜,象征:symbol;变得衰弱:becomefeeble
flamboyant	艳丽夺目的,炫耀的,充满装饰的:strikinglyelaborate
flatter	拍马屁,奉承,讨好:praiseexcessively;自我感觉良好:thinkhighlyof;使显得更漂亮:showadvantageously
flaw	瑕疵,缺点:imperfection;降低,破坏,使不完美:reduceperfection
fledgling	新生:startingoutinafield
fleet	舰队,车队:groupofavehicles;迅速的:withgreatspeed;快速涌过:passswiftly
flexible	灵活的,可变的:readilychanged;易受影响的:susceptibletoinfluence
flinch	畏缩;退缩:drawback
flippancy	轻率,无礼:unbecominglevity
flirt	调情:behaveamorously;无规则地快速运动:makeirregularmovements
flit	快速或突然地经过:passquickly
flock	人群,兽群:creaturesmassedtogether;聚集,集体行动:travelinaflock
florid	辞藻华丽的,花哨的:fancyexpressions;装饰华丽的:elaboratelydecorated
flounder	笨拙地行动,挣扎:actclumsily
flourish	茂盛,繁荣:achievesuccess;装饰:ornamentation
flout	嘲弄性不理会,蔑视:treatwithdisregard
fluctuate	波动,无规则地变动:shiftbackandforth
fluent	表达流利的:abletoexpresswell;不费力的:minimaldifficulty
fluky	侥幸的:happeningbygoodluck;偶然的:bychance
flush	（肤色）健康红润的:healthyreddish;富有的:moneyinabundance;大量的:abundance;冲洗:pourliquid
fluster	使慌乱:putintoagitatedconfusion
foible	小缺点:minorflaw
foil	挫败:preventfrombeingsuccessful
foment	助长,煽动:promotethegrowth
foolproof	十分简单以至于不会失败的:leavenoopportunityforerror,misuseorfailure
footloose	无拘无束的,自由的:havingnoattachments
forbearance	克制,忍耐:toleranceandrestraint;友好仁慈的态度:kind,gentleorcompassionatetreatment
forebear	祖先:anancestor
forestall	预先阻止:preventbeforehand
foreword	前言:preface
forge	伪造:imitatefalsely;铸造,铸就:form;
formidable	令人害怕的:causingfear;艰难的:requiringeffort
forthright	直率的,说话率真的:freeinexpressingopinions;直接的,不绕弯子的:freefromambiguityorevasiveness:goingstraighttothepoint
fortify	加固,鼓励:givephysicalstrength;做好心理准备:preparementally
foster	促进,鼓励,培养:helpthegrowth;养育:bringtomaturity
founder	建立者:oneestablishes;完败:failutterly;沉没:becomesubmerged
fracas	争吵,吵闹:physicaldispute,noisyfight
fracture	破裂:breaking;打碎,破坏:separateintopieces
fragile	易碎的:broken;易受伤的,脆弱的:easilyinjured
frail	虚弱的:weak;（意志）薄弱的:weak;（希望）渺茫的:slight
fraudulent	欺诈的:fraud
fraught	充满的:full;令人忧虑的:emotionaldistress
frenzy	疯狂,狂怒:mentalagitation
frequent	时常拜访:often;时常发生的,重复再现的:shortintervals
fretful	易怒的,烦躁的:vexed
friable	易碎的:easilycrumbled
friction	摩擦:rubbing;冲突,不和:clashing;
frigid	严寒的:cold;冷漠的:lackingwarmth
fringe	边缘:border;与…接壤,位于…的边缘:beadjacent
frivolous	轻浮的:unbecominglevity;不重要的:littleimportance
frothy	用轻薄材料制作的:light;（内容等）快乐轻佻、不严肃的:gailyfrivolous
frowsy	邋遢的:slovenly;味道难闻的:unpleasantsmell
frugal	节约的:economy
frustrate	挫败,阻挠:prevent;使沮丧:lessenthecourage
full-bodied	重要的:importance;味道浓烈的:richnessflavor
fulminate	大声斥责:thunderousdenunciation
fumble	笨拙地做:awkwardattempts;（无意识的）失误:departurefromtruth
furor	喧闹,狂怒,激动,狂热:intenseexcitement
furtive	鬼鬼祟祟的;秘密的:stealth
fury	暴怒:rage
fussy	谨慎的:involvinggreatcare;过分雕琢的:excessivelydecorated;挑剔的:hardtoplease
fusty	过时的:old-fashioned;腐臭的:staleodors
futile	无效的,无用的:ineffective;不严肃的:lackinginseriousness
gadfly	刺激物:provocativestimulus;令人反感的人:annoys
gaffe	（社交上）失礼,失态:socialblunder;明显的错误,错误判断:blatantmistake
gainsay	否认:declarefalse;反对:oppose
gall	（使）焦躁,激怒:irritate;深深的敌意:illwill;大胆,无耻:boldness
gallant	英勇的:brave,chivalrous;高贵的,慷慨的:dignifiedandgenerous
galvanize	（好似用电击）刺激:stimulateexcite
gamble	赌博,孤注一掷:bet;（使）受到威胁,冒险:indanger
gambol	欢跳,雀跃:playfully
gangly	身材瘦长的:tall
garble	曲解,篡改,混淆（以至使无法理解）:distortmisleading;筛选,除杂:remove
gargantuan	巨大的:tremendous;
garish	过于鲜艳的,过于张扬的:stridentcolor
garment	衣服:clothing
garrulous	啰嗦的,话多得令人厌烦的:tiresomely,talkative
gash	深长的伤口或切口:deepcut;砍伤,切开:makegash
gasification	气化:gas;
gauche	笨拙的,缺乏社交经验的:lackinggrace
gaudy	俗丽的:excessivelyshowy
gauge	测量标准:measurementstandard;判定:determine
gear	调整（以配合）:adjust
genial	和蔼亲切的:easygoing;友好的,热心的:kindlyfeeling;温暖的:neithertoohighnortoolow
genteel	有教养的,不粗俗的:freefromvulgarity
germane	有关的,适当的:relevant
gibe	嘲弄:tauntingwords
giddy	轻率不严肃的:lackinginseriousness;喜悦的:elated
gild	（带欺骗性地）修改,润色:deceptivelyattractive
gist	要点:mainpoint
gladiator	角斗士:engagedfightdeath;参与打斗或辩论的人:engagingincontroversy
glaze	给…上釉,妆点:coatglaze;使平滑:glossysurface
glib	流利圆滑的（常含有不真诚或欺诈的成分）,油腔滑调的:fluencyinsinceredeceitful;缺乏深度的,肤浅的:lackingdepth
glisten	闪光:shinesparkling
glitch	小故障:minormalfunction
gloat	幸灾乐祸,自鸣得意:self-satisfaction
gloomy	黯淡无光的:withoutlight;忧郁的:lowspirits
gloss	简短解释:briefexplanation,obscure;（欺骗性的）光鲜外表:attractiveappearance;敷衍潦草做事（甚至忽略）:toolightly;开脱（罪名）:lessbad
glossy	平滑的,有光泽的:smoothsurface
glut	使过量,使充满:beyondcapacity
glutinous	胶状的粘的:glue
glutton	贪吃者:immoderatefood
goad	刺激,驱使,激发:inciterouse
gobble	狼吞虎咽:eatgreedily
goggle	凝视:look
goldbrick	逃避工作和责任:shirkresponsibilities
gorge	峡谷:canyon;狼吞虎咽:eatgreedily
gossamer	虚无缥缈的东西:insubstantial;轻薄的,薄弱的:light
gourmand	嗜食者,大胃王:excessivelyfondofeating
gourmet	美食家:connoisseurfood
grandeur	宏伟,壮丽:grand
grandiloquent	（语言等）浮夸的:extravagantly,bombastic
grandiose	自命不凡的,浮夸的:grandeur;宏大的:greatness
grandstand	为了给人留下印象而表演,哗众取宠:impress
grate	刮擦（以发出刺耳的声音）:rasping;骚扰,惹恼:irritate
gratify	使满足:desiredplease
gratuitous	无根据的,无理由的:unwarranted;无报酬的,免费的:withoutreturn;多余的:notneeded
green	无经验的:deficientexperience
gregarious	爱社交的:enjoythecompany;群居的:groupwithothers
grieve	（使）感到悲伤:deepsadness
grimace	因痛苦而面部扭曲,（作）怪相,（作）鬼脸:contortionpain,disgustordisapproval
grin	咧嘴笑,咧嘴笑着表示:expressanemotion
gripe	抱怨:dissatisfaction;（通过连续让人讨厌的举动）激怒,惹怒:disturb
grisly	令人反感的,令人恐惧的:repugnance
groove	享受,极其满意,过得快活:takepleasurein
grotesque	难看的:unpleasant
grovel	卑躬屈膝:drawback,fearfulsubmission
grueling	费时间花心思的:requiring
guile	狡猾,狡诈:misleading
guilt	自责,悔恨:wrongdoing
gull	欺骗:untrue
gullible	易受骗的,易被利用的:cheated
gush	（使）大量涌出:greatvolume;（使）情感强烈外溢:exaggerateddisplay
gust	情感爆发:suddenintenseexpression
guzzle	狂饮:drinkgreedily
hack	雇佣文人:writercommercial;乱砍;开辟:irregularblows;成功完成:skillfullyorefficiently;忍受:putupwith
hackneyed	陈腐的,缺乏创新的:lackingfreshnessoriginality
halcyon	宁静的,平静的:freefrom;繁荣的,丰富的:affluent
hale	强壮的,健壮的:freefrominfirmityorillness;拖,拉:causetofollow
half-baked	不明智的:lackofgoodsenseorjudgment
hallmark	典型的特征:conspicuousfeature
hallow	尊敬,把…视为神圣:respect
hallucination	错觉:falseidea
ham-handed	笨手笨脚的:lackingdexterity
hammer	屡次重申:repeated
hamper	阻碍:restrictthemovement,impede
hamstring	使无效,使无力:ineffective
hangdog	伤心的,沮丧的:sad,dejected
hanker	向往,渴望:desire,yearn
haphazard	无秩序的,无目标的:lackofplan,orderordirection
harangue	（发表）长篇大论:longpompous
harass	烦扰:irritatepersistently;耗尽…的体力:useup
harbinger	预言者:presages
harbor	提供住处,隐匿:providehabitat;心怀,牢记:keepinone’smind
hard-bitten	顽强的,经受得住困境、压力的:abletowithstand
hardy	顽强的:abletowithstand;愿意冒风险的:willingtotakerisks
harmonious	和谐一致的:agreeablyrelated
harness	利用:utilize
harrow	折磨,使苦恼:distresstorment
harry	不断烦扰,骚扰:distress,harass
harsh	粗糙的,不具有美感的:coarseroughdisagreeablesense;严厉的:exacting
hasten	促进:speed-up,accelerate
hasty	轻率的:superficialexcessiveorcarelessspeed
haunt	常去拜访:frequent;不断地想起,萦绕心头:obsess
hauteur	傲慢,自大:arrogance
haven	安全的地方:placeofsafety
havoc	大混乱:outoforder;大范围破坏:nonexistentunsoundoruseless
headlong	鲁莽的:withoutdeliberation
hearken	倾听,关注:attention
hearten	给予鼓励,鼓舞:givestrengthcourage,encourage
heartrending	令人心碎的:sorrowdistress
hedonism	享乐主义:doctrinepleasure
hegemony	霸权,统治权:preponderantauthority
heinous	可憎的,十恶不赦的:hatefully
hew	遵守:confirm,holdtosomethingfirmly;支持:steadfastsupport
herald	告知,宣布:makeknown;预示,预兆:indicationofbeforehand
heresy	异教,和普遍观点相悖的说话:controversialorunorthodoxopinion
heretical	异教的,异端邪说的:departurestandards
hermetic	深奥的:abstruseness
hesitance	犹豫,不情愿:hesitant,reluctant
heterodox	非正统的,异端的:unorthodoxopinions
hidebound	死板的,极度保守的:tendingtofavor
hideous	非常丑陋的:ugly
hie	匆匆忙忙:hasten
hike	（使）上涨:riseuptoahigherplaceorposition
hilarious	非常好笑的:extremelyfunny
histrionic	戏剧的,演员的:relatingtoactors
hive	忙碌之地:activity;储备,积累:storeup
hoard	贮藏,秘藏:keephidden
hoary	极老的:extremelyold
hoax	欺骗:causetobelieveuntrue
hodgepodge	大杂烩:mixturedissimilar
homage	尊敬,敬意:respect
homely	其貌不扬的,朴素简单的:notattractive
homily	冗长乏味的道德演讲或训诫:admonition
homogenize	使统一化:makeagreesingleestablishedstandard
hone	磨快:sharpen
hoodwink	欺骗:deceptive
hortative	鼓励的:exhortation
hovel	茅屋:smallwretcheddirty
hubris	狂妄自大:exaggeratedpride,self-confidence
humble	谦逊的:meekness,modesty;顺从的,谦卑的:humilityorunseemlysubmissiveness
humility	谦卑,谦逊:absenceofanyfeelingsbetter
humor	幽默,令人发笑的事物:comicaloramusing;迎合,迁就:complywith
hurricane	飓风:aviolentrotatingstorm;飓风般的事物,引起动荡的事物:resemblingahurricane
husband	节俭,勤俭持家:useeconomically
husk	（果类或谷物的）外壳:outercovering;剥去:remove
husky	（尤指声音）沙哑的,粗糙的:rough;高大威猛的:muscular
hybrid	杂交品种,混合品种:mixedorigin;杂交的:parentsofdifferentraces
hymn	赞歌,赞美诗:songofpraise;赞美:proclaimtheglory
hyperbole	夸张:exaggerationusedforemphasis
hypnotic	催眠的:causesleep
hypocritical	虚伪的:notbeingwhatoneappearstobe
iconoclast	特立独行的人:notconformacceptedstandards
idolatrize	（通常盲目）崇拜:admiresintensely
idyll	无忧无虑的生活:carefreeepisode
ignite	点燃:setfireto;激起,唤起（感情）:arousethepassions
ignominy	耻辱:losttheesteem
illiteracy	文盲:unabletoreadandwrite
illuminati	智者:enlightened;精英:bestofaclass
illuminate	照明:makeshining;阐明:makeplain;启迪,启发:spiritualunderstanding
illusory	幻觉的,虚幻的:illusion
imbibe	喝水,摄取水分:takeinliquid
imbroglio	困境,复杂的局面:complicatedsituation;纷争:angryexpressionofdifferingopinions
imitation	仿制品:likesomethingelse
immaculate	干净的,纯净的:freefromdirt;完美的,没有任何错误的:withoutfault
immanent	内在的:innermost
immaterial	非实体的:notcomposedofmatter;无关的,不重要的:norelevance
immature	未完全发展的,未发育成熟的:lackingcompletegrowth;（思维、举止）不够成熟的:lackingmaturity
immemorial	古老的:fromthedistantpast
immune	不易被感染的,有免疫力的:havingresistancetoinfection;不受影响的:notaffectedbyinfluence;不受约束的,免除的:notsubjecttoanobligation
immure	监禁,禁闭;使闭门不出:confine
immutable	不可变的:notcapableofchanging
impassive	冷漠的,无感情的:nosignoffeeling
impeccable	无罪的:freefromsin;无暇的,无可挑剔的:freefromfault
impecunious	贫穷的:nomoney
impede	妨碍,阻碍:slowtheprogressof
impending	即将发生的:soontotakeplace
impenetrable	不可渗透的,不可穿透的:impossibletogetthrough;难以理解的:incapableofbeingcomprehended
impenitent	不悔悟的:notregretful
imperative	命令:mustbeobeyed;命令的,强制性的:forcingone’scompliance;迫切的:needingimmediateattention;必要的:impossibletodowithout
imperial	帝国的,帝王的:empire;巨大的,令人惊叹的:impressiveinsize
imperious	爱发号施令的:orderingpeople;傲慢的,专横呃:arrogantlydomineering;迫切的:compelling
impertinent	无关紧要的:nothavingrelevance;粗鲁无礼的,大胆的:insolentrudeness;不守礼节的,不为他人着想的:lackofmanners
imperturbable	沉着冷静的,淡定的:extremecalm
impervious	不可渗透的,不可穿透的:notallowingentrance;不能被破坏的:notcapableofbeingdamaged;不为所动的:notcapableofbeingaffected
impetuous	冲动的,性急的,轻率的:impulsivevehemence;剧烈的,猛烈的:violenceofmovement
impious	不敬神的:lackingreverence
implacable	固执的:stickingtoanopinion;无法平息的:notcapableofbeingappeased
implement	工具:device;执行,实施:carryout
implode	（使）剧烈收缩,（使）坍塌,（使）内爆:collapseinward
imposing	恳求,迫切请求:urgentmanner
importune	宏伟壮丽的:impressive
impostor	冒充者:assumesfalseidentity
impotent	无生育能力的:unabletoproducefruit;无力的,无能的:lackinginpower
imprecise	不精确的:notprecise
impromptu	即席的表演:doneextemporaneously;即席的,即兴的:withoutpreviouspreparation
improvise	即兴而作:performwithlittleornopreparation
imprudent	不明智的:lackinggoodjudgment
impudent	放肆大胆的,无礼的:boldnessordisregard
impugn	责难,攻击,抨击:attackasfalse
impuissance	无权,虚弱:lackofpower
inadvertent	偶然发生的:bychance;疏忽的,不留意的:unintentionallackofcare
inalienable	不可剥夺的,不能让与的:cannotbetransferred
inane	空洞的:lackingsignificance
inanimate	无生命的:notliving
inaugurate	使就职:inductintoanoffice;开始:begin
incandescent	明亮灿烂的:bright;热情饱满的,感情强烈的:zeal
incantation	咒语:magicpower
incarnate	化身的,人性化的:bodilynatureandform;使（思想、理论）具体,体现:constituteanembodiment
incendiary	煽动者:personwhostirsup;煽动性的:tendingtoinflame
incense	芳香:pleasantsmell;激怒:extremelyangry
inception	开端,开始:beginning
incessant	无间断的:withoutinterruption
inch	少量,很短的距离:smalldegree;（使）慢慢移动:moveslowly
inchoate	新生的,才开始的:earlystage;未完全成型的:imperfectlyformed
incinerate	将…烧成灰烬:burntoashes
incipient	起初的,初现的:beginningtocomeintobeing
incite	煽动,激起:provoke
inclement	（天气等）恶劣的:lackingmildness;无情的,残酷的:unmerciful
incogitant	考虑不周到的,不体谅的:inconsiderate
incongruent	不全等的;不一致的:notconforming
inconsequential	不合逻辑的:notfollowinggoodreasoning;不重要的:nosignificance
incontrovertible	无可争议的:notopentoquestion
incorrigible	不可救药的,积习难改的:incapableofbeingcorrected;无法管制的:impossibletocontrol
incriminate	归罪于:accuseofacrime
incubate	孵化:coverandwarmeggs;帮助,培养,促进:aid
inculpate	归罪于:incriminate
incursion	入侵:hostileentrance
indelible	（印记等）无法擦除的:impossibletoremove;无法忘怀的:noteasilyforgotten
indemnity	（损害、伤害等的）保险赔偿:compensation
indict	起诉,控告:accuse
indifferent	公平的:impartiality;（质量、档次等）中规中矩的,一般的:average;不感兴趣的,冷漠的:lackofinterest
indigenous	土产的,本地的:originating;与生俱来的,先天的:innermostnature
indigent	贫穷的:lackingmoney
indispensable	必不可少的,不可或缺的:impossibletodowithout
indoctrinate	教育,灌输思想:instruct
indolent	懒惰的:aversetoactivity
inducement	动机,刺激源:motive;劝说,游说:pleadingwithsomeonetoaccept
indulgent	（对己）放纵的,（对他人）纵容的:giventoindulgence
indurate	铁石心肠的,冷酷无情的:alackofsympathy;使变硬:physicallyfirm;使习惯于（如艰苦或尴尬之境况）:withstandphysicalhardship
industrious	勤勉的:diligent
ineffable	难以表达的:incapableexpressed
ineluctable	无法逃避的,必然的:nottobeavoided
inept	愚笨的,荒谬的:lackofjudgment;不恰当的,不合时宜的:notappropriate;不称职的,无能力的:incompetent
inert	（人）懒惰缺乏活力的;（物品）惰性的:sluggish,deficient
inevitable	不可避免的,必然的:incapableavoided
inexorable	无法劝阻的,不为所动的:notpersuaded
infamous	臭名昭著的:badreputation
infatuate	使迷恋:inspireunreasoninglove
inferno	大火:fire;地狱:resembleshell
infiltrate	秘密潜入:entersurreptitiously
infinite	无尽的,无限的:noboundaries
infirm	虚弱的:weakinbody;不果断的,优柔寡断的:lackingfirmnessofwill
inflame	点燃,燃烧:setonfire;使加剧:moreviolent
infelicitous	不愉快的,不幸的:unfortunate;不恰当的,不合时宜的:notappropriate
influx	涌入:comingin
infuse	激怒:makefurious
infuriate	灌输,使…充满:fill;鼓舞:inspire
ingenious	聪明的,有创造才能的:resourceful,cleverness
ingenuity	独创性,创新性:inventive
ingenuous	天真纯朴的:lackingcunning;坦白的:straightforward
ingest	摄入,咽下:takeintobody
ingrained	本质的,根深蒂固的:firmlyestablished
ingratiating	讨人喜欢的:winningfavor;逢迎的,意在奉承的:gainfavor
inherent	内在的,本质的:essential
inimical	带有敌意的:hostility;危及某人利益的,不利的:opposedtointerests
inimitable	无法效仿的,独特的:notimitated
iniquity	邪恶,不公正:immorality,injustice
initiate	创造,发动促进:causebeginning;刚入门的新手:personinitiation
inkling	轻微暗示,小提示:slightindication;略知:vaguenotion
innocuous	无害的:noinjury;乏味的,不会引起敌意的:notarouse
innovative	创新性的:introducinginnovations
inquisitive	过分好奇的:inordinatelycurious
insensible	无知觉的:lostconsciousness;漠不关心的:notresponsive;粗俗的,没品味的:lackinginrefinement
insensitive	缺乏机智圆滑的,缺乏社交技巧的:lackingtact;不敏感的,麻木的:notresponsive
insentient	无感觉的,无知觉的:lackingperception;一知半解的,略懂的:nothavingadeepunderstanding
insight	深刻的理解:apprehendingnature
insipid	（食品）清淡无味的:lackingfavor;平淡的,无聊的:lackinginterest
insolent	粗野的,无礼的:rude
insouciant	无忧虑的,不在乎的:freefromconcern
instate	任命:establishrank
instigate	煽动,激起:urgeforward,stirup
instill	慢慢滴入:enter;灌输:impart
institute	创立,制定:establish;机构:organization
insubordinate	不服从权威的:notsubmissive
insular	（观念、想法等）孤立狭隘的:narrowprovincialviewpoint
insulate	使绝缘,使隔离:detachedsituation
insurgent	叛乱分子:opposesauthority
intangible	无法感知的,无形的:capableperceived
integral	构成整体所必需的:essential;完整的:notlackinganypart
integrity	正直:adherencemoral;完整性:beingwhole
intelligible	可理解的:beingunderstood
intemperate	无节制的,极端的,不温和的:nottemperate
intensify	加强,激化:makeintense
inter	埋葬:placeingrave
intercessor	调停者:mediates
interdict	禁止:forbid;阻止:stop,seizeorinterrupt
interim	中间过渡时期,间隔:timebetweenevent;暂时的:forthetimebeing
interlock	连锁,连结:joinedclosely
interminable	无尽头的:noend
intermittent	间歇的,断断续续的:notcontinuous;不定期的:lackingregularity
interregnum	过渡期:break
interrogate	质问,审问:questionformally
intimate	有紧密联系的,亲密无间的:closeassociation;不为人知的:notknown;密友:personwhohasastrongliking;迂回地交流,间接地沟通:communicateindirectly
intimidate	威吓:frighten
intoxicant	使人陶醉的东西（尤指酒精饮料）:intoxicates
intransigent	不妥协的,固执的:refusaltocompromise
intrepid	无谓的:resolutefearlessness
intrigue	阴谋:asecretplan;激起…的兴趣:arousecuriosity
intrinsic	固有的,内在的:essential
intuitive	直觉的:byintuition
inundate	淹没:coverwithflood
inure	使习惯接受不好的东西:accustom;使坚强:withstandphysicalhardship
invective	侮辱性的:characterizedbyinsult
inveigh	激烈抗议,表示强烈不满:protestvehemently
inveigle	诱骗:winoverbycoaxing
inventory	存货清单:listallgoods;（包含要点的）简介:shortstatement
inveterate	积习的:firmlyestablished
invidious	惹人反感的:causediscontent;羡慕嫉妒恨的:resentmentofanother’spossessions
invigorate	使精神,使强壮,鼓舞激励:impartvigor
invincible	不可战胜的,不可超越的:incapableconquered
invoke	实施:putintoeffect;产生,造成:bethecause
irascible	易怒的:easilyprovokedanger
irate	极其愤怒的:extremelyangry
iridescent	五颜六色的:lustrouscolors
irk	令人烦恼的事物:sourceofirritation;使烦恼,使厌倦:irritating
ironclad	非常坚固的,坚不可摧的:unbreakable
irradicable	不能根除的:impossibledestroy
irreducible	（数）不可约分的:incapablefactored
irrigate	灌溉:supplywater;冲洗:flush
irritate	刺激,惹恼:provokeanger
issue	（有争议的）话题,议题:matterthatisindispute;发布（期刊）等:produceandrelease;（使）流出:flowout
jabber	快而不清楚地说:talkrapidly,indistinctly
jaded	疲惫的:depletedinstrength;厌倦的,没兴趣没热情的:patienceexhausted
jape	嘲弄:mockingly
jargon	行业术语:specializedortechnicallanguage
jarring	刺耳的:discordant;震惊的:strongemotionalreaction
jaundice	（因嫉妒或厌世而产生的）偏见:bias
jaunty	轻快呃,活泼的:sprightly
jejune	无趣乏味的:notinteresting;幼稚的:annoyingqualitieschildren
jettison	丢弃,投弃:cast
jeopardy	危险:risk,danger
jest	轻浮的态度,戏谑:frivolous
jibe	意见一致:agree
jingoist	极端爱国激进分子（通常表现为好战的对外政策）:extremenationalismbelligerent
jitters	紧张,不安:panic,nervousness
jocular	搞笑的,欢乐的:joking,playful
jocund	欢快的,高兴的:sprightlylighthearted
jog	慢跑:movementexercise;唤起:rouse
jolt	突然移动:movesudden;惊吓:unpleasantsurprise
jot	简要记录:writebriefly
jovial	愉快的:good-mannered,jollity,conviviality
jubilant	喜悦的:joyful
judicious	明智的,慎重的:judgmentprudent
juggernaut	无法阻挡的力量的,摧毁一切的强大力量:overwhelmingforce
ken	视野范围:vision;知道,了解（人或物）:know
kidnap	绑架勒索:detainunlawfulforce
kindle	点燃:setfire,ignite
kindred	类似的;具有相似或相近的起源、本性或性质的:similarorigin
knack	诀窍,聪明的做法:clever
knead	揉捏,塑造:shapebyfolding
knit	编织（纱线）:interlacingyarnwithneedles;连接,联系:joinclosely
knotty	多结的,复杂的,困难的:fullofdifficultiescomplications
kudos	名望,名声:fame;夸奖,赞扬:acclaimorpraise
labile	易变的,不稳定的:unstable
laborious	勤奋的:industrious;费力的:long,hardwork
labyrinthine	迷宫似的,复杂曲折的:extremelycomplexstructure
lacerate	使非常痛苦:causepain
lackluster	黯淡无光泽的:lackingbrightness
laconic	简洁（以至于显得粗鲁或难以理解的）:minimumofwords,concise
lachrymose	催人泪下的,悲伤的:mournful
lambaste	严厉斥责:scoldsharply
lament	悼词:compositiongrief;抱怨:resentment;为…哀悼,表达痛苦或遗憾:expresssorrow
lamentable	值得惋惜的,悲哀的:deplorable
lampoon	讽刺:harshsatire
languid	没精打采的,虚弱的:lackingenergy
languish	变得衰弱:becomefeeble
languor	懒惰:inertness;衰弱:weakness,weariness
lank	细长瘦弱的:longlean;不僵硬的,柔软松弛的:limp,notstiff
lapse	小过失:slighterror;结束,终止:end
largesse	捐赠物:withoutexpectationofareturn;慷慨:liberality
lash	击打:hardstrike;猛击,撞击:strikewithforce;捆扎:bind
lassitude	乏力,没精打采:diminishedenergy
latent	潜在的,不活跃的:potential,notevident
latitude	（行动或言论）自由:freedom
laudatory	表示赞扬的:praise
lavish	奢侈的,大量的,无节制的:extravaganceandprofusion;挥霍,浪费:givereadilycarelessly
leaven	在…中加入轻松、活泼或变更的因素:minglepermeate
leer	一瞥,斜眼看:sidelong
leery	怀疑的,不信任的:suspicious
legacy	遗产:handeddownancestor
legend	传奇,传说:popularmyth;图例:explanatorylistmap
legion	大量的人,（尤指）军团:largebodyofmen;大量的:numerous
lenient	宽大仁慈的:merciful
lethal	非常有害的,致命的:extremelyharmful
lethargic	没精打采的,行动迟缓的:sluggish
levelheaded	明智的:sensible
levity	轻浮:frivolity
liability	责任:liable;障碍,不利条件:createsdifficulty
liberal	思想前卫的:notbound;慷慨的,大方的:generosity
libertine	放荡不羁者:withoutmoralrestraint
licentious	放荡的,性欲强的:lackingrestraints
liken	显示相似,把…比作:showassimilar
limber	可塑的,柔软的:flexible
limp	柔软的,松散的:lackingfirm;软弱的,没有精神的:lackingstrength;跛行,艰难地行走:haltinglyorunsteadily
limpid	透明清澈的:transparentclearness;镇定的,淡定的:freefromagitation
linger	磨蹭,闲荡:proceedslowly
lissome	柔软的:easilybent;敏捷的,轻盈的:movewithease
list	（使）倾斜:atanangle
lithe	敏捷的,轻盈的:grace;柔软的:easilybent
loath	不情愿的,讨厌的:reluctant
loathe	厌恶:dislike
lofty	崇高的:elevated;高的:rising;自大的:superiority
loll	懒洋洋地行动:lazy;偷懒,打发时间:doingnothing
lopsided	歪的,倾斜的:leaning;不平衡的,不协调的:lackinginbalance
loquacious	话多的:excessivetalk
loutish	粗鲁的:awkward,stupidandboorish
lubricate	使润滑:reducefriction
lucid	有光亮的:suffusedwithlight;神志清楚的:fulluseofone’smind;表达清晰的,简单易懂的:easilyunderstood
lug	拖动,拉动:causetofollow;费力搬运:laboriously
lugubrious	（故作夸张的）悲哀的:mournful
lull	相对平静时期,间隙:momentaryhalt;使镇静,使安心:freefromdistress
lullaby	催眠曲:songlullsleep;使镇静,使安心:freefromdistress
lumber	木材:treelogs;笨拙地行动:clumsiness;使负担（从而拖累）:burden
luminary	杰出人物:eminence
lurch	蹒跚:swaying
lurk	潜伏:lieinwait
lush	茂盛呃:vigorously;多产的:producingabundantly;（声音、味道）优美的,令人愉悦的:appealing
lustrous	有光泽的:shiny
luxurious	豪华的:wealthandcomfort;奢侈的:excessivegratification
lyric	（可以哼唱的）小曲:musicalcomposition;如诗歌般流畅优美的:suggestiveofpoetryormusic
macabre	恐怖的:horrorofdeath
macerate	浸泡（以软化）:soakingorsteeping
maculate	使有斑点,弄脏;玷污,损坏:spot
maelstrom	漩涡:violentwhirlpool;混乱、动荡的局势:turbulent
magnificent	壮丽的:strikinglyimpressive
maladroit	笨拙的:lackofnimbleness
malaise	不舒服:bodilydiscomfort
malcontent	不满分子:opposition;不满的:dissatisfied
malicious	恶意的:deliberatelyharmful
malign	恶意的:causesuffering;诽谤:utterinjuriously
malinger	装病以逃避工作:pretendillness
malleable	可塑的:capableofbeingshaped;易控制的:capableofbeingcontrolled
malodorous	恶臭的:unpleasantsmell
mandatory	强制的:forcingcompliance
mangle	损毁,使伤残:injury;弄砸:ruin
mangy	卑劣的:contemptible
mania	热衷,狂热:intenseenthusiasm
manifest	显然的,明显易懂:understanding;显现,显露:makeevident
manipulate	巧妙操作:skillful;巧妙处理,暗中操控:deviously
mannered	不自然的,做作的:artificial
manumit	解放（奴隶）:releasefromslavery
manuscript	手稿:writtenbyhand
mar	污点,坏点:spoilstheappearance;破坏,削弱:impair
marsh	沼泽,湿地:wet
martinet	纪律严明之人:strict
marvel	令人惊奇的事物:surprise,admirationorwonder;（因为壮观、美丽等而）表示惊讶:feelamazement
masquerade	捣碎:pulpymass
mash	面具,伪装:displayinsincere;伪装,掩饰:disguise
mastery	技艺超群,精通:greatskill
matriculate	入学;录取:admitorbeadmitted
maudlin	过于感伤的:tearfullysentimental
maven	专家:experienced
maverick	特立独行之人:doesnotconform;标新立异的,不合常规的:deviating
mawkish	过度伤感的:sentimental
meager	贫乏的:deficient
mean	卑贱的:ignoble;吝啬的:sharinglittle;打算,怀有目的:purposeorgoal;意味着:convey,showorindicate
meander	闲逛,漫步:aimlesslyandidly
measly	少得可怜的,微不足道的:small
measured	深思熟虑的,审慎的:calculated
meddle	干涉,管闲事:intrude
mediate	调解,调停:bringaboutanagreement
mediocre	平庸的,质量中等偏下的:moderate
medley	大杂烩,混合物:mixture
meek	谦恭的:humility;顺从的:submissive
meet	合适的:veryproper
mellifluous	（曲调）优美的:smoothandsweet
melodramatic	感情夸张的,伤感的:exaggeratedlyemotional
menace	威胁,使处于危险:intentiontoharm
mendacious	撒谎的,虚假的:lies
mentor	导师:guide;教导,指导:giveadvice
mercenary	（外国军队的）雇佣军:soldierhired;唯利是图的,贪婪的:monetaryormaterialgain
mercurial	（情绪）善变的:changeablenessofmood
merited	应得的,理所应当的:whatiscalledfor
mesh	诱捕:catch
mesmeric	催命的,催眠术的:mesmerism;令人着迷的,难以抗拒的:attracting
metamorphose	（使）变形:change
metaphysical	哲学上的,理论上的:idea;非尘世的:beyonduniverse
meteoric	流星般迅速而短暂的:brevity
methodical	井然有序的,有条理的:systematicorder
meticulous	极为谨慎的:extremeorexcessivecare
mettle	勇气:strengthofspirit;毅力,耐力:stamina
miff	使恼怒:annoyed
migratory	迁移的:movingfromoneregiontoanother
milk	榨取（财富、信息等）:coerceprofit
mime	模仿:model
mimic	仿真的,伪造的:inappearance;滑稽地模仿（以取笑）:copyorexaggerate;模仿:model
minatory	带来威胁的,有凶兆的:asignofevil
mince	切碎:smallpieces;小步走:shortsteps
mingle	mingle:social;混合,结合:mix
minimize	将…减到最少:reducetosmallest;刻意低估:underestimate;表示鄙夷:scornfullylowopinion
mint	巨额:abundantamount;无损坏的:unmarred
miniscule	极小的:verysmall
minute	仔细的,谨小慎微的:carefulscrutiny;小的,不重要的:ofsmallimportance
minutia	次要的细节,小事:minordetail
mirage	海市蜃楼,幻想:illusory
mire	困境:difficultsituation;使陷入困境,拖后腿:holdback
mirth	欢乐,欢笑:gladnesslaughter
misanthropic	反人类:deepdistrustofhuman
misbehaving	调皮的,行为不端的:childishmisbehavior
mischievous	调皮的,淘气的:naughtyteasing;有害的:causingharm
misconstrue	误解,曲解:mistake
miscreant	恶棍,罪犯:behavescriminally
misdemeanor	轻罪:crimelessserious
miserly	吝啬的:penuriousness
misfortune	不幸:badfortune
misgiving	担忧,忧虑:doubt
mishap	不幸之事:unfortunate
misrepresent	误传,篡改:givemisleadingrepresentation
mite	微小的东西,很少的钱:smallobject
mitigate	减轻痛苦,使缓和:lesssevere
mobile	可移动的:capablemoving;可变的:changeable
mockery	鄙视,嘲弄:ridicule;以嘲笑为目的的模仿:derisiveimitation
moderate	使缓和:lessenintensify;适度的,中庸的:withinlimits
modicum	少量:smallportion
mollify	平息,抚慰,缓和:calm
mollycoddle	宠爱,溺爱:excessiveindulgence
molt	脱（羽、皮等）:shedfeathers
momentous	极重要的:utmostimportance
momentum	动力;冲力;势头:impetus
mongrel	杂种的,混血儿的:mixedorigin
monochromatic	单色的:onecolor;单调无味的:lackingvariety
monologue	独白:byoneactor
monotonous	（声音）单调的:unvaryingtone;清一色的,无聊的:tediouslyunvarying
montage	大杂烩:collection
moratorium	延期,暂缓施行:suspension
morbid	疾病的,疾病所致的:bydisease;（思想性格）变态的:unwholesomethoughts
mordant	尖酸刻薄的:bitingcaustic
moribund	即将结束的,垂死的:approachingdeath;即将过时:obsolete
morose	忧郁的:sullen,gloomy
mosaic	综合物,马赛克般的东西:collection
mosque	清真寺:worshipMuslim
moth-eaten	过时的:passeditstime
motile	能动的:movement
motivate	刺激,激发:provideincentive
motley	混杂的,富于变化的:variety
mottle	标记上杂色斑点:markspots
motto	座右铭:guidingprinciple
mournful	悲伤的:expressingsorrow
movement	运动:moving
muddy	不干净的:notclean;浑浊的,不清晰的:lackingclarity;使难以理解:makeunclear
muffle	使消声:deadenthesound
mulish	固执的:obstinate
mumble	说话含糊:utterconfused
mundane	尘世的,世俗化的:relatingtoworld;平凡的:commonplaces
munificent	慷慨的:liberalingiving
murky	黯淡的,昏暗的:withoutlight;模糊的,晦涩的:lackingclarity
murmur	小声的话语:lowsound;低声抱怨,发牢骚:grumble
mutate	（使）改变,（使）变异:undergomutation
mute	不说话的,缄默的:refrainingfromspeech;使颜色,音调等柔和:soften;减弱声音:mufflethesound
mutter	低声抱怨:murmurcomplainingly
myopic	缺乏远见的,缺乏辨别能力的:lackofforesight
myriad	无限的,大量的:indefinitenumber
nadir	最低点:lowestpoint
naïve	天真纯朴的:lackingworldlyexperience
narcissism	自恋:admirationofoneself
nascent	新生的:recentlycomeintoexistence
natty	整洁的,时髦的:tidy
nauseate	（使）厌恶,（使）作呕:causedisgust
nautical	航海的:onwater
naysay	拒绝,否认:oppose,deny
nebulous	模糊的:indistinct
needy	贫穷的:impoverished
nefarious	极坏的,邪恶的:wicked
negation	否定:opposite
negligent	疏忽大意的:failingcare
negotiate	商量,谈判:bymutualagreement;谋划:planout
neophyte	初学者,新手:beginner
nerve	（坚强的）意志,勇气:powerofendurance;给予勇气,鼓励:givecourage
nettle	惹怒:arouseanger
neutralize	中和:acidundergoneutralization;破坏,使无效:makeinoperativeorineffective
nicety	连结:connection;核心,最重要的地带:greatestimportance
nexus	小口咬:smallbites
nibble	准确,精准:carefuldetails;细微之处:finepoint
nil	不存在,零:nothing
nip	少量:smallamount;小口吃喝:insmallamounts
nitpick	吹毛求疵:criticize
nocturnal	夜间的:inthenight;夜间活动的:activeatnight
noisome	有害的,有毒的:harmful;恶臭的:offensivesmell;非常令人厌恶的:objectionable
nomad	游牧的;居无定所的人:nofixedresidence
nominal	不重要的:unimportant;名义上的:somethinginname
nonchalant	冷漠:indifference
nondescript	平凡的,不吸引人的:lackingdistinctive,interesting
nonentity	不重要的人:littleconsequence;虚构的东西:creatednoobjectivereality
nonplus	使迷惑,使困窘:perplex
nonsense	无意义的话,废话:nomeaning
notch	刻痕:cut;通过努力获得:obtain
novel	新奇的:new
noxious	有害的,有毒的:harmful,injurioustohealth;产生强烈厌恶的:causingintensedispleasure
nuance	细微的差异:subtledistinction
nudge	用肘推以引起注意:pushelbow;说服某人做某事:persuade
nugatory	无关紧要的:consequence,inconsequential
nurture	提供营养:nourishment;培育,培养:providewithunderstanding
oath	誓言:formalpromise
obdurate	固执的:resistantinfluences;冷酷无情的:lackofsympathy
obedient	服从的,顺从的:submissiveauthority
obeisance	敬礼,尊重:respect,submission
obfuscate	使困惑,使模糊:confused,opaque
obligatory	强制性的:compulsory;（见得多以至于）无聊的:dull
obliging	乐于助人的:dofavors
oblique	斜的:inclinedortwisted
obliterate	除去:remove
oblivious	不知道的,不知情的:lackingawareness,notinformed
obloquy	谩骂,诽谤:abusivelylanguage;恶名,耻辱:losttheesteem
obscure	含义模糊的:notclearly,veiled,uncertainmeaning;平凡的,不知名的:famous;使模糊:indistinct
obsequious	谄媚的,奴性的:fawningattentiveness
obsess	迷住的,使困扰:haunt
obstinate	固执的:inspiteofpersuasion;难以减轻或治愈的:moteasilysubdued
obstreperous	难驾驭的,任性的:unruly;吵闹的:loudandinsistentcries
obstruct	妨碍,给…制造困难:impede,createdifficulty;阻挡:preventpassage
obtuse	愚钝的:absorbideasreadily
obviate	排除,使不必要:unnecessary
occult	难以理解的:noteasilyapprehended,mysterious;使隐藏或神秘:keepsecret
odium	憎恶,讨厌:strongdislike
offbeat	不平常的:differentfromgenerallyfound
offhand	即兴的,没有准备的:withoutpreparation
officious	多管闲事的:thrustingoneself
offish	冷淡的:aloof
off-key	不寻常的,不合适的:outofaccordwith
ominous	凶兆的:omen,evil
omniscient	无所不知的:completeknowledge
onerous	费时间花心思的:requiringmuchtime,effort
opaque	不透光的:impenetrablebylight,neithertransparenttranslucent;晦涩的:obscure
opine	表达观点;想,认为:expressopinions
opportune	合适的,恰当的:convenient
opprobrious	辱骂的:reproach;臭名昭著的,令人鄙视的:infamous
oration	（颇有野心、自高自大的）演说:high-flownorpompousmanner
orient	使确定方向,使熟悉或适应:determineposition,makefamiliar
original	创新的:creative,inventive;最初的,最早的:before
orthodox	传统的:establishedform,custom,orrules
oscillate	振动,摇晃:swing;犹豫,变化:vary
ossify	（使）硬化,（使）僵化:hardened,conventional,opposedtochange
ostentatious	卖弄炫耀的:conspicuous,pretentious
ostracize	驱逐:exclude
oust	免职:removefrom;驱逐:driveout
outgoing	友好的,外向的:extroverted
outlandish	古怪的,奇异的:outoftheordinary,bizarre
outmaneuver	以谋略取胜:overcome
outset	开端,开始:beginning
outwit	瞒骗,以智取胜:surpasscunning
overbearing	专横傲慢的:arrogant;压倒一切的,（在力量或重要性上）势不可挡的;支配的,显著的:overwhelminginpower
overlap	（与…）部分重叠:samearea
overt	明显的,公开的:open
overture	前言:introductory,preclude;序曲:introductionopera
oxymoron	矛盾修饰法:combinationcontradictory
pacify	使平静,安慰:easetheanger
padding	夸张,废话:gobeyondthefacts
paean	欢乐颂:joyoussongpraise
painstaking	煞费苦心的:diligentcare
palatable	感到愉悦满足的:pleasureorcontentment
palatial	宫殿般奢华的:ornateness
pall	失去兴趣:interestattraction
palliate	平息,减轻:lesssevereintense
pallid	无生气的,缺乏活力的:lackingradiancevitality;苍白无血色的:pale
palmy	繁荣的:prosperity
palpable	摸得到的:capabletouched;明显的,易觉察的:obvious
palter	欺骗,讨价还价:insincerelydeceitfully
paltry	无价值的,微不足道的:importance;让人厌恶的,让人鄙视的:loathinganddisgust
pan	严厉批评:harshcriticism
panache	炫耀:flamboyance
pandemic	大范围流行的:widespread
pandemonium	喧嚣,骚动:noise
panegyric	赞颂之词,颂文:eulogistic
panoramic	全景的:completeview
parable	寓言:teachabasictruth
paradigm	典范,模范:pattern
paradise	天堂,极乐世界:perfectionandhappiness;快乐,狂喜:pleasurableemotion
paradox	表面矛盾实际可能正确的话,悖论:opposedtocommonsense
paragon	优秀模范:example;把…比作,显示相似:compare
paramount	最重要的:chiefimportance
paranoid	多疑的,对他人极端恐惧和怀疑的:extremefearofdistrust
paraphrase	转述,意译,改写;indifferentwords
parch	炽,烤,烤干:dry
parenthesis	间断:interruption
pariah	被排斥或鄙视的人:despisedorrejected
parity	相称,同等,平等:beingequal
parody	（以嘲笑原作作者的）模仿作品:imitatedforridicule;模仿（以嘲弄）:copytomakefun
paroxysm	（感情、动作的）突发:outburst;（政治、社会领域呃）大动荡:disturbance
parrot	（机械地）模仿,复制:imitatewithoutunderstanding
parry	躲避（问题）:evade
parsimonious	过度节俭的,吝啬的:stinginess
partial	偏袒的,偏爱的:biased;部分的,不完整的:lacking
particularize	详述:givedetails
partisan	跟随者,信徒:follows;（狂热.坚定的）拥护者,支持者:excessivelydevoted;偏袒的:oneside
pastiche	（带嘲讽的）模仿:imitateswithsatiricalintent;大杂烩:hodgepodge
partition	分割,划分:dividing
patent	显而易见的,明显的:readilyvisible
pathological	不正常的,病态的:markedlyabnormal
patina	外表:superficial;（由内而外散发的）氛围,气场:appearanceoraura
patrician	贵族,名门望族:highbirth;贵族的,地位高的:highbirth
patriot	爱国者:lovescountry
patronize	赞助:provideaid;以高人一等的态度对待:treathaughtily
paucity	少量,缺乏:dearth
paunchy	大腹便便的,大肚子的:potbelly
peck	大量:considerableamount;（不情愿地）小口咬:insmallbites
pedagogue	教育者,老师:giveformalinstruction
pedant	书呆子,墨守成规之人:formalrules
predestine	预先注定:inadvance
pedestrian	行人:travelingonfoot;平庸无奇的,令人厌倦的:causingweariness
peep	一瞥:brieflook;轻声:slightsound
peer	同等地位的人,同辈:equal;好奇地凝视:look
peeve	打扰,惹恼:disturb
pejorative	轻蔑的,贬低的:disparaging
pellucid	透明的:admittinglight;清晰明确的,易懂的:clear
pen	监狱:confinement;关押,监禁:close
penalty	（对罪行的）处罚:punishment
penchant	嗜好,迷恋:stronginclination
penitent	悔过的:regretful
pensive	沉思的,（尤指）哀思的:thinking
penury	贫穷:dearth;吝啬,节俭:frugality
perambulate	徒步穿越,走过:travelover
perceptible	可察觉的:beingperceived
peremptory	不容反抗的:notallowingcontradiction;爱发号施令的:orderingpeople;傲慢的:feelingofsuperiority
perfervid	非常热情的:exaggeratedemotion
perfidy	不忠,背信弃义:disloyalty
perforate	打孔,穿透:makeahole
perfunctory	例行公事的,敷衍的:superficially;不感兴趣的:lackingininterest
perimeter	边界,界限:outerlimit
periodical	期刊:publication;周期性的,有固定间隔的:regularintervals
peripatetic	巡游的,四处游历的:placetoplace
peripheral	外围的:boundaryorperiphery;辅助性的:supply
perish	死亡,消亡:ceasetoexist
permanent	永恒的:continuingorenduring,forever
permeable	可渗透的:penetrated
pernicious	有害的:injurious
peroration	（演讲的）结束语:concludingpart;（正式的）演讲,致辞:formaldiscourse
perpetual	永恒的,不断的:continuingforever
persecute	迫害,折磨:causesuffering
persevere	坚持不懈,不屈不挠:persist
persiflage	打趣:teasing
persistence	坚持,持续:lastingexistence
personable	风度翩翩的,吸引人的:attractive
perspicacious	极敏锐的,有洞察力的:penetratingmentaldiscernment
perspicuity	清晰明了的:clearnessandlucidity
pertain	有关联的:havearelation
pertinacious	顽固的,固执地坚持的:sticking
pertinent	相关的,恰当的:relevance
perturb	使扰乱,使烦躁不安:troublethemind
peruse	细读:examinewithgreatcare
pervade	弥漫,充满:throughout
pessimistic	悲观的:takethegloomiestpossibleview
petition	请愿,正式的申请,申请书:supplicationorrequest;（尤指正式地）请求:,makearequest
petrify	使僵化,使失去活力:becomestiff
petty	细微的,不重要的:smallimportance
phenomenal	不寻常的,非凡的:outoftheordinary
philanthropic	博爱的,为他人着想的:welfareofothers
philistine	市侩（注重物质而鄙视智慧或艺术的人）:guidedbymaterialism
phlegmatic	冷静的,无感情的,淡漠的:calm,sluggishtemperament
piddling	微不足道的:triflingortrivial
piebald	杂色的:differentcolors;混合的,杂糅而成的:differentsorts
pigment	颜料:color;给…上颜色:color
pilfer	偷窃:steal
pillar	柱子:support;（物质、精神等方面的）支柱:support
pillory	当众嘲弄:publiccontempt
pilot	领航员,飞行员:steeraship;初步性的,试验性的:tentativemodel;带领通过:lead
pine	渴望,奢望:yearn;因渴望而憔悴:losevigor
pinnacle	顶峰:highestpoint
pinpoint	非常精确的:extremeprecision;精确定位或确认:identifywithprecision
piquant	辛辣开胃的:pungenttaste;令人振奋的:provocative
pique	使愤怒:arouseanger;激起,刺激:exciteorarouse
pirate	盗版,盗用:withoutactualright;海岛:robberseas
pithy	精练的,简洁的:brief
pitiless	没有同情心的:devoidofpity
pittance	少量津贴:smallportion
placate	（通过让步以）平息抚慰:lessentheanger
placebo	安慰性的事物:usedtoappeaseorreassure
plagiarize	剽窃,抄袭:stealideas
plangent	轰鸣的:loudsound;凄凉的,哀伤的:plaintive
plastic	可塑的:modified;虚假的,做作的:lackinginnatural
plateau	高原:raisedabove;稳定时期,平台期:stablelevel
platitude	陈词滥调:banalstatement;缺乏原创性:lackoforiginality
plausible	看似有理的:superficiallyreasonable
pleat	打褶:fold
plentitude	大量:ampleamount
plethora	过量,过剩:excess
pliable	易弯曲的,柔软的:supple;易受影响的,温顺的:easilyinfluenced
pliant	易弯曲的:easilybent;顺从的:yielding
plight	困境:unfortunate
plod	沉重缓慢地走:walkheavily
pluck	敢于面对困难的勇气:courage;弹奏（弦乐）:stringspullingreleasing
plumb	测深度:measurethedepth;垂直的:vertical;仔细深入地检查;探索,探究:examinedeeply
plummet	突然下降:declinesuddenly
plump	丰满的:well-around;鼎力支持,赞不绝口:givefullsupport
plunge	突然下降:descendsuddenly;插入,刺入:penetrate
polarize	使分开对立,使两极分化:breakintoopposing
polemic	争执:argument
polished	有教养的:highdegreeofrefinement;擦亮的:shiny
politic	精明能干的:shrewdness;合时宜的,明智的:suitable
pompous	浮夸的:ornate;傲慢的:self-importance
ponderable	有价值的,值得考虑的:considerable
ponderous	沉重的:greatweight;沉闷无聊的:unpleasantlydull
pontificate	傲慢地说或做:speakpompous
pore	仔细浏览,仔细研究:readorstudyattentively
porous	多孔可渗透的:admittingliquid
portentous	预兆性的,凶兆的:signofevil;勾起兴趣的,令人遐想的:elicitingamazement
poseur	故作姿态的,不真诚的人:affectedinsincere
posit	假定,断定:affirm
postulate	前提条件:startingpoint;假定为真:assumetrue
posture	姿势,姿态:wayofholdingthebody;故作姿态,装模作样:pretendedattitude
potable	饮品,尤指有酒精饮料:beverage;适于饮用的:suitablefordrinking
potentate	有权势的人:hasthepower
potentiate	激活,加强:moreactive
pout	（尤指撅嘴或板着脸）表示不悦:showdispleasure
practitioner	职业人士:profession
prairie	大草原:treelessgrassland
prate	闲聊,空谈:talkidly
preach	传道,布道:sermon
precarious	危险的,不稳定的:lackingsecurity,stability;可疑的,不明确的:uncertain
precedent	先例,前例:earlieroccurrence;先前的:prior
precipice	悬崖峭壁:steep
precipitate	匆忙的:carelessspeed;促使,导致:causetohappen
precipitation	沉积物,尤指降水:deposit,rain,snow;仓促:disorderlyspeed
precipitous	非常陡峭的:steep;匆忙的:carelessspeed
preclude	预先阻止:makeimpossibleinadvance;排斥:exclude
precursor	先驱者,先导:precedes
predecessor	前任,先辈:previouslyoccupied
predilection	爱好,偏袒:dispositionfavor
preeminent	优秀的,重要的:paramount
preempt	预先占有:seize,beforeothers;替换:replace
preen	整理（羽毛）:smoothfeathers;打扮修饰:dressoneselfelaborate;自满:takepride
preface	序言:preliminarystatement
pregnant	重要的,意味深长的:fullofmeaning;怀孕的:containingoffspring
premeditate	预先考虑:considerbeforehand
preoccupation	非常关系,全神贯注:extremeconcern
preponderant	占优势的,更重要的:superiorimportance
prepossessing	给人好感的,有魅力的:impressfavorably
preposterous	荒谬的,不符合常理的:contrarycommonsense
presage	征兆:signorwarning;预示,预言:predict
prescience	预知,先见:knowledgebefore
prescription	规定,传统的规矩:rule
preservative	防腐剂:protectagainstdecay
prestige	声望,威望:respect
presumptuous	放肆的,冒昧的:oversteppingbounds;傲慢的:feelingofsuperiority
pretense	虚假,伪装:pretendingdeceive;自大,优越感:exaggeratedsenseofone’simportance
preternatural	超乎寻常:surpassingusual
prevail	盛行,战胜:greaterinstrength
prevalent	流行的,普遍的:commonlyaccepted
prevaricate	支吾其词,撒谎:evadetruth
primordial	原始的,最初的:happeningfirst
primp	精心打扮:adornfinicky
principal	主要的,重要的:highestimportance,rank
pristine	纯净的,质朴的,未被文明腐蚀的:pure,freefromdirtordecay
privation	缺乏,穷困:lack
probe	深入调查:penetratinginvestigation
probity	正直:moralstandards
proclivity	癖性,爱好:inclination
procrastinate	（因为懒散）拖延:putofflaziness
procure	获得,取得:getpossession
prod	促使…行动:persuade
prodigal	挥霍的:spendthrift;败家子:spendsfreely
prodigious	巨大的:greatinsize;惊人的,了不起的:astonishment
profane	亵渎:treatabuse,irreverence,contempt;滥用:badorimproperuse
proffer	献出,提供:offer
proficient	熟练的,精通的:advancedcompetence
profligate	挥金如土的,挥霍的:wasteful;败家子:spendsmoneyfreely;堕落的人:belowthenormalmoralstandard
profundity	深奥,深刻:abstruse
profusion	丰富,大量:abundance;挥霍,浪费:wasteful
prohibitive	禁止的,阻止的:prohibit,restrain;（价格高得）抑制购买的:purchase
proliferate	快速繁殖;激增:growormultiplybyrapidlyoffspring
prolix	啰嗦的,冗长的:excessivelength
prologue	序言:preface
prolong	延长,拖延:lengthen
proofread	正式宣布:makeknown
promulgate	校对:finderrorsandmarkcorrections
propagate	繁殖:increase;传播,宣传:spreadout
propensity	倾向,癖好:inclination
prophetic	预言的,预示的:foretelling
propitiate	抚慰,劝解:appease
propitious	吉祥的:favorablyhappyoutcome
proponent	建议者,支持者:support
propriety	礼节:conformitysociallyacceptable;适当,得体:suitableorfitting
prosaic	单调的,常见的:normalcourseofevents
proscribe	禁止,排斥:forbid
prosecution	实行,执行:doing
proselytize	（使）改变信仰:changereligiousfaith
prospect	探查,勘探:gointodiscovery;期待,期望的事物:lookingforwardto
prosperous	成功的,繁盛的:vigorousgrowth,well-being
prostrate	平躺（的）,使平躺:lyingflat;衰弱的,使衰竭:weakness
protean	善变的;多才多艺的:diversity,variety,versatile
protocol	正确的礼仪规范:correctconduct
protract	延长,拖长:lengthen,prolong
protrude	突出:project
protuberant	隆起的,凸出的:thrustingout
provident	节俭的:frugal,economical;有远见的:awarenessforthefuture
providential	天意的,幸运（的）:divineintervention
provincial	狭隘（的）:limitedperspective
provisional	临时的:temporary
provisory	有附带条件的;临时的:conditional
provoke	激怒:inciteanger;驱使,激起:stirfeeling
prowess	英勇,勇敢:superior,courage
prowl	潜行于,巡游以猎取食物,徘徊:roamthroughsearchofprey
prude	过分正经的人:一个过分关心自己是否得体、谦逊、或正确的人:greatlyconcernedseemlybehaviorandmorally
prudish	明智的:wisdom,judiciousness,wise;小心谨慎的,审慎的:circumspection
prudent	过分守礼的:prudery
prune	梅干:plumdried;修剪;修正
pry	刺探,打听:inquireclosely,curiously;
pseudonym	假名,笔名:fictitious
psychology	心理学:sciencementalprocessandbehavior;心理战术:subtletacticalactioninfluence
pucker	撇（嘴）,（使）收缩:contracted
puckish	淘气的,顽皮的:mischievous,impish
puerile	幼稚的,不成熟的:immature
puissance	权力:power
pulchritude	美丽:beauty
pulverize	将…研磨成粉;将…彻底摧毁:completeend
pun	双关语:humorous
punctilious	注意细节的,一丝不苟的:attentivedetails
pundit	权威人士,专家:opinionsauthoritative
pungent	辛辣的,讽刺的:useofwitcausehurtfeelings
puny	微小的,弱小的:inferiorsize,weak
purity	纯净;纯洁,纯在:clean,morallypure
purlieu	常去的地方:socializing;临近的地区:adjoiningregion
purloin	偷窃:steal
purvey	（大量）供给,供应:supply
pusillanimous	懦弱的,胆小得令人鄙视的:timidity
quack	骗子医生,江湖郎中:pretender
quaff	大口地喝:drinkheartily
quail	胆怯,畏缩:fear,cower
qualify	限定:reducegeneral;使有资格,使有能力:makecompetent
quandary	困惑,窘境:perplexity,doubt
quarantine	隔离:isolation
quarry	采石场:stoneisobtained;目标,猎物:pursuit
quash	镇压,阻止:putastopto
quaver	发颤音:quiveringvoice
quell	压制:suppress;使平静,使安静:pacify
quench	熄灭:putout;使满足:putacompleteendto
querulous	抱怨的,爱发牢骚的:complaining
quibble	吹毛求疵:criticize,cavil;牵强之词:微不足道的差别或不切中要点的异议,小反对:minorobjection
quiescent	平静的,静止的:quiet,inactive
quixotic	不切实际的,空想的:morebyidealsthanbyreality
quota	配额,限额:proportional
quotidian	每日的,平凡的:commonplace
rabble	混乱的人群;暴民;下层群众:disorganizedcrowdofpeople
rabid	狂热的,不冷静的:fanatical
racy	活泼生动的:vigorous
raffish	低俗的:crudeness
raffle	垃圾,废物:discarded,useless
rage	暴怒:violentanger
ragged	衣衫褴褛的:threadbareclothes;凹凸不平的,不光滑的:notsmooth
rail	猛骂,猛烈抨击:revileorscold
rakish	放荡的,行为不检的:loweredmoralcharacter
ramble	漫步,漫游:moveaimlessly;漫谈,长篇大论（并经常离题）地说或写:withoutatopic
rambunctious	喧闹的,骚乱的:noisy
ramshackle	摇摇欲坠的:readytocollapse
rancor	敌意,深仇:illwill
random	随机的,随意的:lackingpattern
rankle	激怒:causeanger
rant	（尤指长时间的）训斥,责骂:angryscolding;怒吼:noisy,angryorviolentmanner
rapacious	食量大的,贪食的:hugeappetite;过度贪婪的:covetous
rapport	和睦,友好:friendlyrelationship
rapprochement	和睦,友好:cordialrelations
rapscallion	流氓,恶棍:evil
rapt	狂喜的,狂热的:pleasurableemotion;全神贯注的:deeplyabsorbed
rash	使稀薄:makerare
rarefy	草率的,仓促的:lackcaution
raspy	声音刺耳的:harsh;容易生气的:easilyirritated
ratify	（官方地）认可,批准:officialacceptance
ratiocination	推理:thoughtprocesses
ration	定额供应量,配给量:amountallotted;按比例分配:shareorportion
rational	合乎逻辑的:logical;理性的:basedonreasoning
rave	狂热赞扬:exaggerateddisplayofaffection;（发疯般的）怒吼:talkasifindelirium
ravel	解开,松开:separatestrands;阐明:claritybyseparating;使纠缠,使复杂化:tangle
ravish	使陶醉,使沉迷:overcomewithemotion
raze	摧毁,粉碎:destroycompletely
react	做出反应:inresponse
reactionary	反对改革的,极保守的:oppositiontoprogress
ream	怒斥,训斥:criticize
reap	收割,收获:receive
reassure	使安心,打消疑虑:restoretoconfidence
rebuff	严词拒绝:reject
recalcitrant	顽抗的,不顺从的:resistancedefiance
recant	撤回,放弃,改变:withdrawastatement
recessive	（基因等）隐性的,由隐性基因控制的:doesnotproduceacharacteristiceffectwhenpresentwithadominantallele;内向的,内敛的:notcomfortablearoundpeople
recidivate	回到原先的习惯,尤指重新犯罪:returntocriminalhabits
reciprocate	往复运动:forwardandbackward;报答,回报:return
reckless	不考虑后果的,大胆鲁莽的:careless
recluse	隐士:livesaway;隐居的,不爱社交的:withdrawalfromsociety
recoil	退却,畏缩:shrinkback
reconcile	使和解,协调:harmony
recondite	深奥的,难解的:difficulttocomprehend
reconnoiter	侦察,勘查:makeapreliminaryinspection
reconstitute	重建,（尤其是通过加水）使复原:restorebyaddingwater
reconvene	重新集合,重新召集:gatherorsummonagain
rectitude	正直:moralintegrity
recumbent	躺着的:lyingdown
recuperate	恢复（健康或力量）,康复:recoverhealth
redolent	芳香的:fragrance
redoubtable	杰出的,值得尊敬的:worthyofrespect;可怕的:arousingfear
redundant	多余的,冗余的:exceedingnecessary
reel	感到眩晕:frombeingtwirledaround;蹒跚地走路:swayingfromsidetoside
referee	仲裁者;裁判员:impartiallyresolvesadispute;（就纠纷或争论）给出意见:giveanopinion
refine	提纯,精炼:freefromimpurities;改善,改进:improveorperfect
reflect	反射:changedirection;反映,显露:makemanifest;思考:thinkseriously
refractory	倔强的,不顺从的:resistingcontrol
refulgent	辉煌的,灿烂的:shinningradiantly
refute	否认:declarenottobetrue;证明为假,证伪:provewrong
regenerate	使重获新生,使焕然一新:bringbacktolife;（使）洗心革面:betterincharacter
regimen	（政治上的）统治:lawfulcontrol
regress	后退:back;退化,恶化:worse
rehabilitate	使复原,使康复:restoretohealthycondition;（使）洗心革面:betterincharacter
rehearsal	排练,彩排:practicinginpreparation
reign	统治权:righttocommand;占统治地位或盛行:bepredominant
rein	抑制,限制:keepingwithincertainboundaries;抑制,控制:keepfromexceeding
reiterate	重申:stateagain
rejoice	欣喜,喜悦:feeljoy
relapse	故态复萌,再犯:fallback
release	排放:giveoff;释放,使获得自由:setfree;解雇:letgofromoffice
relentless	残酷的,无情的:noabatementorseverity;固执的,不肯妥协的:yieldinginone’spurpose
relevant	有关系的,重要的:havingconnection
religion	宗教,信仰:beliefs;（对于宗教信仰的）忠诚,虔诚:loyaltytoGod
relinquish	放弃（职位,权力等）:giveup;移交,交出:givecontrolorpossession
relish	喜好,偏好:appreciationorliking;（愿望达成时的）高兴,满足感:whenwishesaremet;享受,喜欢:takepleasure
reluctant	不情愿的,反感的:showingunwillingness
remiss	疏忽的,不留心的:carelessness
remodel	改造,改变结构:alterthestructure
remonstrance	抗议,抱怨:expressionofprotect,complaint
remorse	懊悔,悔恨:bitterregret
remunerate	支付报酬,补偿:pay
rend	撕裂,猛拉:tearorsplitapart
renegade	背教者,叛徒:rejectsallegiance
renounce	（正式地）放弃:giveup;宣布与…决裂:refusetofollow
renovate	修复,维修:restore;使重获新生,使焕然一新:bringbacktolife
repartee	机智的回答:wittyresponse;打趣,善意的玩笑:good-naturedteasing
repatriate	遣返:returntocountry
repeal	撤销,废除（法律等）:rescindorannul;宣布与…决裂:refusetorecognize
repel	抵制:fightagainst;使厌恶:causeaversion
repertoire	（技术、设备或原料等的）详单:completelist
repine	抱怨、表达不满:expressdiscontent;渴望:longfor
replete	彻底吃饱了的:appetitecompletelysatisfied;充满…的,富于…的:possessinggreatnumbers
repose	（劳作后的）休息:stateofresting;平静,宁静:freedomfromstorm;休息:takearest;放置,交给他人:safekeepingoranother
reprehend	谴责,责难,批评:expressunfavorableopinion
repress	镇压:putdownbyforce;阻止（正常的表达、活动或发展等）:preventexpression
reprieve	对...暂缓处刑,免罪:postponeorcancelpunishment;维持...的运行:preventfrombeingclosed
reproach	令人羞愧的事物,耻辱:causesshame;批评,责备:expresscriticism
reprobate	堕落者,道德败坏的人:unprincipledperson;堕落的,放荡的:morallycorrupt;谴责,痛斥:condemnstrongly;拒绝,不提供:unwillingtogrant
reproof	批评,反对:criticism
reprove	温和地责备,警告:scoldgently;不欣赏,不喜欢:unfavorableopinion
repudiate	否认:declarenottobetrue;拒绝接受:unwillingnesstoaccept
repugnant	令人厌恶的:arousingaversion;不和谐的,不协调的:notharmony
repulse	使厌恶,排斥:rejectwithdenial
repute	（尤指好的）名声,名誉:goodreputation
requite	酬谢,报答:makerepayment;报仇:punishinkind
requisite	必需品:somethingnecessary;必不可少的,必备的:necessary
rescind	废除,取消:makevoid
reserved	内向的,缄默的:restrained
residue	剩余物:remains
resign	辞职,放弃（职位）:giveupoffice
resilience	弹力:resumeoriginalshape;恢复能力:abilitytorecoverquickly
resolute	坚定的:firmdetermination
resonant	（声音）洪亮的,共鸣的:strongintone
resourceful	有创造力的,机智的:actimaginatively
respite	间歇,休息:rest
respire	呼吸:inhale,exhaleair
resplendent	华丽辉煌的:brilliantly
responsive	反应的,敏感的:quicktorespond
restive	急躁的,忧虑的:impatience,uneasiness;难以管束的:resistingcontrol
restless	不平静的:lackofquite
restrain	限制,控制:limit,restrict
resurgence	复兴:restoration
resuscitate	使复活,使苏醒:restoreconsciousness
retainer	家仆:service
retaliate	报复,反击:payback
retard	减速,延迟:causeslowly
retinue	随行人员:groupofretainers
reticent	沉默不语的:inclinedtobesilent;不愿意的:slowtobegin
retort	（尤指机智的）回应,回答:quick,wittyreply
retouch	润饰,改进:improve
retract	收回,否认:takeback
retrench	削减开支:curtailexpenses
retribution	报酬,报应:rewardorpunishment
retrograde	倒退的:movingbackward;退步,退化:decline
retrospective	回顾的:lookingback
revelry	狂乐,喧闹的作乐:noisypartying
revenge	报复,复仇:retaliating;为...复仇:retaliatinginkind
revere	（尤指对神的）尊崇,尊敬:respect
revise	更改,修正:improve
revive	恢复意识:returntoconsciousness;再获新生:activeagain
revoke	撤回,宣告无效:annul
revolt	使厌恶,使反感:fillwithdisgust;反叛:renounceallegiance
ribald	（举止、言语）下流粗鄙的:vulgar
rickety	不稳的:lackingstability
rider	骑马的人:rides;（议案的）附加条款:appended
ridicule	嘲笑:makefun
rife	丰富的,普遍的:greatnumbers
rift	分裂,不和:breakfriendly;使开裂:break
rile	刺激,惹怒:makeagitated
ripen	使成熟,变成熟:makeripe
riot	喧闹,暴乱:publicviolence
rite	惯例,仪式:prescribedform
rive	撕开:tearapart
riveting	吸引人的,极迷人的:absorbingengrossing
rivulet	小河,小溪:smallstream
robust	精力充沛的,强壮的,健康的:fullofstrength
roil	搅浑,使混乱:stirup;激怒:displease
roisterer	喝酒喧闹的人:engagesinmerrymaking
rookie	新兵;新生;菜鸟:recruit
roster	值勤表,花名册:listofpersonnel
rostrum	讲坛,演讲坛:stagespeaking
rouse	激起,煽动:stirup;唤醒:stopsleeping
royalty	皇家身份:regalcharacter;版税;专利权税:payment
rubicund	红润的,健康的:healthyrosiness
rudimentary	初始的,未发展的:earliestdevelopment;最根本的,基础的:firstprinciples
rue	后悔,遗憾:feelingofregret
ruffle	皱褶,褶裥花边:stripedge;使粗糙:destroysmoothness;扰乱,打扰:disturb
ruminate	沉思:gooverinthemind
rumple	使皱,弄皱:formcreases;打乱,使不整齐:undotheproperorder
run	（不间断的）连续演出:courseofperformances
runic	神秘的:mysterious
rupture	打破;打碎,破裂:part
ruse	诡计:subterfuge
rustic	乡下人,头脑简单的人:awkwardorsimpleperson;乡村的:openareaswithfewbuildings;粗俗的:lackingpolish
rustle	快速地行动:moveoractwithspeed
sabotage	妨害,破坏:hinderacause;从事破坏活动,阻止:practicesabotage
saccharine	像糖一样的,有甜味的:sugar;做作的,矫情的:appealingtotheemotions
sacrilege	亵渎圣物:profanationsacred
saddle	使某人担负:load
safeguard	保护措施:preventaccident;保护:makesafe
sage	智者:wisdom
salient	显著的,最突出的:conspicuously
salubrious	有益健康的:promotinghealth
salutary	有益健康的:promotinghealth;有利的,利好的:promotingwell-being
salutation	致敬,打招呼（表示欢迎和礼貌）:greeting;赞扬:praise
salvage	（从灾难中）抢救:savefromloss
salve	减轻:缓解:assuage
sanctify	使神圣,将...敬为神:makeholy
sanctimonious	假装虔诚的:hypocriticallypious
sanction	批准,同意,许可:makevalid;制裁:coercivemeasure
sanctuary	避难所:protection
sand	磨光:makesmooth
sanguine	乐观的,确信的:freefromdoubt;面色红润的:healthyreddish
sanitary	健康的,清洁的:health
sap	削弱:weakenenergyvitality;健康,活力:activestrength
sapient	聪明的,有洞察力的:deepunderstanding,intelligent
sarcasm	讽刺,轻蔑:ironic
sartorial	裁缝匠的,裁缝的:clothes
sate	使饱足,充分满足:satisfyfully
satiate	（使）饱足（的）,过分满足（的）:satisfyfully
satire	讽刺诗,讽刺文学:literaryridicule
satirize	讽刺:ridicule
saturate	使饱和,浸透:wetthoroughly
saturnine	忧郁的,阴沉的:lackingincheer;讽刺的:sardonic
saunter	闲逛,漫步:byfoot
savant	博学之士,学者:learning
savory	口感好的,味道好的:appetizingtaste,smell;令人愉悦的,pleasureorcontentment
savvy	老练,机智:knowledgeactuallydoing;明确了解:clearideaof;有见识的,精明能干的:practicalclevernessorjudgment
scads	许多,大量:largenumber
scant	不足的,缺乏的:scarcely
scathing	尖酸刻薄的:causehurtfeelings
schism	不一致:lackofagreement
scintillate	闪耀:sparks
scion	子孙:descendant
scission	切断,分离,分裂:division
scoff	嘲笑:derision,mock;狼吞虎咽:eatgreedily
scorch	炙烤,烘干:burn,makedry
scorn	轻蔑,鄙视,不屑:rejectcontemptible
scotch	停止:putanendto
scour	用力擦洗:washvigorously;搜查:tofindordiscover
scowl	皱眉（表现出不高兴）:expressiondispleasure
scrappy	好斗的,好吵架的:aggressive
scrap	废料,废物:discardedoruseless;抛弃:getridof;终止,放弃原计划:putanendto
scrawl	乱涂,潦草地写:writecarelessly
scribble	潦草地书写,乱写:meaningless
scrupulous	正直的:principled;一丝不苟的:greatcareandeffort
scrutable	可以理解的:understoodcomprehensible
scrutinize	仔细检查:observegreatcare
scuff	（使）磨损:roughenedbywear;脚步拖沓:moveheavily
scurrilous	说粗话的:vulgar
scurvy	下流的,让人鄙视的:contemptible
seamy	肮脏的,堕落的:sordid,base
secluded	僻静的,隐蔽的:hidden
secrete	隐藏:conceal;分泌:generate
sedate	淡定的,安静的:freefromagitation
sedentary	固定不动的:notmigratory
seduce	劝说（使不忠,使不服从）,诱...误入歧途:persuade
sedulous	勤奋认真的:carefulperseverance
seemly	得体的,遵守礼节的:followingtheestablishedtraditions
segment	分割;部分:separate
self-abasement	自卑,自谦:humiliation
self-absorbed	自恋的,自私的:absorbedinonesown
seminal	有发展性的:contributinglaterdevelopment;创新的:creative
sensation	感觉,知觉:sense;轰动事件:intenseinterest
sensitive	敏感的:susceptible
sentinel	哨兵,看守:watchesover
sepulchral	阴沉的,丧葬的:lackingincheer
septic	腐败的,感染的:putrefaction
sequela	结果:secondaryresult
sequester	使隔离,分离:segregate;使隐退:seclusion
sere	干枯的,凋萎的:dried,withered
serendipity	意外发现珍奇（或称心）事物的本领:byaccident
serene	安静的:freefromuproar;稳重的,镇静的:unaffected,calm
sermon	布道,说教:publicspeechmoral
serpentine	弯曲的:winding
serrate	锯齿状的:notched
serried	密集的:littlespace
servile	低下的,卑屈的:submissive,abject
severe	严厉的,要求严格的:exactingstandards;难以承受的,艰难的:difficulttoendure
shackle	束缚:restrictions;限制,阻碍:createdifficulty
shadow	偷偷尾随:secretlytrail;遮蔽,（使）变暗:gloomy
shallow	浅显的,浅薄的:lackofdepthofunderstanding
sham	欺瞒:deceitfulness;掩饰,假装:presentafalseappearance;虚假的:fake
shiftless	胸无大志的,懒惰的:lackingambition
shipshape	井然有序的:order
shirk	逃避,规避:keepawayfrom
shoal	浅的:littledepth
shopworn	陈旧的:worn-out
shred	少量:smallamount
shrewd	精明的,机敏的:clevernessorjudgment;刺骨的,强烈的:discomfort
shrink	（在数量或价值方面）降低,减小:reduced;（使）本能性地退却（如因遇到使人惊恐的事物）,（使）退缩:drawback;表示出不情愿,犹豫:hesitate
shroud	隐蔽物,可起隐蔽、保护或屏护作用的物体:conceals,protects,screens;将...从视线中隔离,遮蔽:shutofffromsight
shrug	轻视,忽略:dismiss;脱下（衣物等）:rid
shun	避开,避免:keepaway
sidestep	（通过逃避而）不遵守:avoidhavingtocomplywith
signal	（在重要性、成就方面）非同寻常的:standingabove;给出信号:directornotify
simpleton	（缺乏常识的）笨蛋:lackingincommonsense
simulate	假装,模仿:takeontheappearance;模拟:createarepresentation
sin	罪恶的事:highlyreprehensible
sincere	真诚的,不做作的:withoutpretense
sinecure	美差:requireslittleornowork
sinew	活力,力量:vigorousstrength
singe	轻微烧焦:burnsuperficially
sinuous	蜿蜒的,迂回的:irregularcurves
sip	（尤指小口地）喝:swallowinliquidform
skeleton	骨架,框架:structuralframework
skeptic	怀疑者:doubts,questionsordisagrees
skimp	缺乏的,不足的:lessplentiful;节省花费,吝啬:giveinsufficientfunds
skirmish	小冲突,争论:minor
skirt	界限,边界:markstheouterlimit;绕行,避开:goaround
slack	松弛的:nottightlyfastened;疏忽的,大意的:failingtogivepropercare
slake	使满足:satisfy
slant	（看待问题、思考的）角度,看法:wayoflooking;倾斜的:slantingdirection;歪曲（事实等）:createawrongimpression
slate	列入名单,计划,安排:putonalist
slew	大量,许多:largeamount
slight	不重要的:deficientinweight;轻微的:smallindegree;轻蔑,看不起:treatwithdisdain;忽略,疏忽:failtogiveproperattention
sling	投掷:sendthroughtheair
slippery	光滑的:slide;隐秘的:actinginsecret;意义不明确的:notpreciseinmeaning
slipshod	粗心的,随意的:indifferencetoexactness,precision,andaccuracy
sloppy	邋遢的,不整洁的:lackingneatness;混乱的:lackinginorder
sloth	怠惰,懒惰:disinclinationtoaction
slouch	懒人:lazyperson;缓慢行走:moveslowly
slovenly	邋遢的,不整洁的:lackingneatness
sluggard	懒人:lazyperson
sluggish	缓慢的,迟缓的:slowinmovement;迟钝的,反应慢的:slowtorespond
slumber	睡着:sleep
slur	耻辱:markofguilt;含糊地发音:indistinctly;疏忽,忽略:withoutdue,consideration
sly	狡猾的:cleverorcunning;隐秘的,偷偷的:actinginsecret
smarmy	虚情假意的,过分恭维的:hypocritically
smart	反应敏捷的,聪颖的:sharpquickthought;整洁的:strikinglyneat;感到疼痛,感到痛苦:sufferacutely
smattering	浅薄的知识:superficialknowledge;少量:smallamount
smirk	（自鸣得意地）笑:offensivelyself-satisfied
smother	使窒息:killedbylackofair;抑制（表达,说出）,压制:refrain
smug	自大的,自鸣得意的:opinionofoneself;整洁的,有序的:goodorder
smuggling	走私,私运:importationorexportationcontrarytothelaw
snare	无法逃脱的困境:catchesandholds;捕捉:captureby
snarl	纠缠,纠结:twist;咆哮,怒吼:toanger
sneer	（轻蔑地）嘲笑:scornful
snobbish	谄上傲下的,自大的:offensiveairofsuperiority
snub	轻视,不理睬:contemptorneglect
soak	使...湿透:makethoroughlywet
sober	严肃的:serious-looking;节制的:restraint;有理有据的:soundreasoning
sodden	湿透的:penetratedbywater;使...湿透:wetthoroughly
solace	安慰:comfortinsorrow;安慰,安抚:console
solder	连接,联合:unite
solemnity	庄严,严肃:solemn
solicitous	为他人操心的,体谅他人的:happinessofothers;迫切的,渴望的:urgentdesire
solid	固态的,坚固的:noteasilyyieldtopressure;有理有据的:soundreasoning;坚定的,不迟疑的:notshowingweakness
soliloquy	（尤指自言自语的）独白:withoutaddressingalistener
solitude	孤独,避世:beingalone
solvent	有偿付能力的:abletopaydebts;溶剂:anothersubstanceisdissolved
somatic	肉体的:ofthebody
somber	昏暗的,无光的:shaded;悲伤的,不愉快的:lackingincheer
somnolence	瞌睡,嗜睡:needingsleep
sonnet	十四行诗:14-lineverseform
soothe	带来慰藉,安慰:bringcomfort;使镇静,使安心:freefromdistress;弱化,缓解:lesssevere
sop	安慰物:placateorsoothe;贿赂,回扣:improperlyinfluenceapersonsconduct;浸湿,湿透:wetthoroughly
sophism	假推理,诡辩:deceptiveargumentation
sophisticated	精明的,老于世故的:worldlyknowledgeorrefinement;复杂的:complex
soporific	催眠的药剂,安眠药:inducessleep;催眠的:causesleep;慵懒的,困倦的:sleepinessorlethargy
sordid	肮脏的,不干净的:notclean;卑鄙的:baseness
sound	牢固的,不可动摇的:withstandstresswithoutstructuraldamage;健康的,强壮的:freefrominjury;（逻辑）上严谨的:validreasoning
sparse	稀疏的,稀少的:lessplentiful
spartan	简朴的,节约的:simplicity
spat	（小的）争吵:quarrel
spate	突发的洪水:suddenflood;大量:largenumber
specific	特有的,独特的:exactsort;明确的:clearlyexpressed
specious	似是而非的,欺骗性的:falselookoftruth
speck	小点,少量:smallamount
spectator	观众,目击者,旁观者:watches
spectrum	光谱,范围,系列:sequenceorrange
speculate	推测,揣测:taketobetrue;投机倒买:frommarketfluctuations
spendthrift	挥霍家,败家子:spendsimprovidently;挥霍的,不节俭的:spendingmoneyfreely
spent	精疲力竭的:drainedofenergy
spindly	细长纤弱的:frailorflimsy
spiny	多刺的:spines;棘手的,麻烦的:requiringexceptionalskill
spleen	怒气,怨恨:angerorillwill
splice	接合,叠接:unite
spontaneous	自发的,不经思索的:withoutapparentthought
spoof	轻松幽默的模仿,小恶搞:exaggeratesforcomiceffect;诱骗,诱使相信:believewhatistrue
sporadic	偶尔的,零星发生的:notoftenoccurring
sprawl	杂乱无序地发展;蔓生,蔓延:irregularly
sprightly	活泼的,充满活力的:fullofvitality
spur	刺激物:arousesaction;支撑物:holdsup;刺激,激励:incite
spurious	假的,伪造的:lackingauthenticity
spurn	摒弃,拒绝:rejectwithdisdain
squabble	口角,小争吵:quarrel
squalid	污秽的,肮脏的:dirty;道德败坏的:repulsive
squall	（通常伴随雨或雪的）风暴,暴风雪,暴风雨:violentwindstorm;尖叫:scream
squander	使分散:apart;浪费:spendwastefully
squat	又矮又胖的:broadinbuild,shortinstature
squint	斜视,睥睨:glancessideways
squelch	压制,镇压（运动）:stopbyforce;击溃,使无言以对:putdownorsilence
stabilize	使稳定;变得稳定:makeorbecomestable
stalwart	无所畏惧的:nofear;（体魄等）强健的:strengthvigor;坚定的:firm,resolute
stamina	耐力:moralstrength;
stammer	口吃,结巴:speakwithpauses
startle	使吓一跳,使大吃一惊:frightenorsurprise
static	静态的;停滞的:lackofmovement;无改变的:littlechange
stature	高度,身高:height;才干,水平:quality,status
steadfast	坚定的,忠诚的:firminbelief
stealth	秘密行动:proceedingfurtively;秘密的:nottoattractattention
steep	浸泡:makewet;陡峭的:approachingperpendicular;过分的,过高的:beyondlimit
stench	臭气,恶臭:foulodor
stentorian	声音洪亮的:loud
sterile	贫瘠的:notproductive;无菌的:freefrombacteria
stickler	坚持细节的人,一丝不苟的人:insistonexactness
stiff	僵硬的,无法弯曲的:lackingsuppleness;（在社交场合）缺乏优雅的,不自在的:lackingsocialgrace;过分的,过高的:beyondlimit;艰苦的,费力的:requiringeffort
stifle	抑制（声音、呼吸等）;阻止,扼杀:holdback
stigma	耻辱,污名:markofshame
stint	吝惜,节省:befrugal
stingy	小气的,吝啬的:unwilling;极少量的:lessplentiful
stipple	（雕刻时）点刻,用点标记:markwithsmallspots
stipulate	规定,特定要求:specifyagreement
stitch	突然剧痛:sharpunpleasantsensation
stock	库存,储备:inventory;普通的,常备的:commonlyused
stockade	栅栏,围栏:enclosure;监狱:confinement
stodgy	平庸的,乏味的:dull;非常守旧的:old-fashioned
stoke	添加燃料:supplyfuel;增大,促进:makegreater
stoic	隐忍的,冷静的:unaffectedbypleasureorpain
stolid	无动于衷的,感情麻木的:littleemotion
stomach	容忍:bear
stonewall	拒绝（合作）,阻挠:uncooperative,obstructive
stouthearted	勇敢的:stout,spirit
stratagem	谋略,策略:deceiving
strait	海峡:channeljoiningwater;痛苦:suffering
strand	绳,线之一股:singlefilament;遗弃,使置之困境:leaveinaunfavorableplace
stratify	将...分成各种等级:divideintoclasses
stray	漫无目的:lackingpurpose;离群,迷途,偏离:moveaway,deviate
strength	力量:abilitytoexerteffort;（抵抗攻击、压力的）强度:abilitytowithstandforce
striate	加条纹:markwithstriations
stricture	责难,批评:criticism
stride	迈大步走:longsteps
strident	刺耳的:harshsound
strike	攻击:forceorviolence;铸造（奖牌）:formbystamping;击打:deliverablow;袭击,攻击:violentaction;撞击:forcefulcontact
stringent	紧绷的:tight;严格的:markedbyrigor
strip	脱衣,剥去:removeclothing
strut	趾高气昂地走:walkpompous;支柱,压杆strengthenaframework
studio	工作室,画室,摄影室:workingplaceofapainter
stultify	使无效,抑制:renderfutile
stupor	迟钝,麻痹,无知觉:suspendedsense
stunt	阻碍（成长）:hindergrowth
sturdy	强健的,结实的:strengthen
stygian	极阴暗的:extremelydark
stymie	阻碍:presentanobstacle
subdue	使顺从;征服:conquer
subject	臣民,受支配的人:underauthority;取决于（其他因素）的:undertheinfluence
subjugate	征服,镇压:bringundercontrol;剥夺...的自由:makesubservient
sublime	崇高的,庄严的:highmoral;（因为杰出、尊贵、美丽等而）令人惊叹的:inspireawe
subliminal	下意识的,潜在意识的:belowperception
submerge	使淹没:underwater
submissive	服从的,顺从的,恭顺的:submitting
subordinate	下级的,次要的:lowerrank;征服:underonescontrol
subservient	奉承的,屈从的:obsequiously
subside	下陷,下沉,减弱:tenddownward
subsidiary	次要的:secondaryimportance;起辅助作用的:aid,support
subsidy	补助金,津贴:monetarysupport
substantial	物质的:havingsubstance;有重大意义的:considerableinimportance
substantiate	证实:supportwithproof;使实体化:givematerial
substantive	本质的,关键的:relatingtotheessence
subterfuge	诡计:deceptiontoconceal
subtle	微妙的,难以感知的:difficultperceive;巧妙的,间接或带有欺骗性的:cleverdeceptivemeans
subvert	颠覆:overturn
succinct	简明的,简洁的:clear,precise
succor	救援,援助:aid
suffocate	使窒息:depriveofoxygen
suffuse	（色彩等）弥漫,染遍,充满:spreadthrough
sulk	生气,愠怒:resentment
sullen	闷闷不乐的:lackingincheer
summary	摘要:abstract;就地的,立即的:onthespot
summit	顶点:highestpoint
summon	召集,召唤:calltogether;传唤（出庭、出席）:commandtoappearincourt
sumptuous	豪华的,奢侈的:extremelyluxurious
sunder	分裂,分离:breakapart
supercilious	高傲的,傲慢的:haughty
superficial	表面的,肤浅的:lackingdepth
superfluous	多余的,过剩的:exceedingsufficient
superimpose	添（声）加（色）（使形象、某因素或性质更加清楚）:adddistinct
supine	懒散的,倦怠的,消极的,漠不关心的:lethargy,indifference
supple	易弯曲的,柔软的:bent,pliant
supplant	排挤,篡夺...的位置:usurptheplaceof
supplement	增补,补充:completeforadeficiency
supplicate	恳求,乞求:makearequestearnestorurgent
supposition	猜想,推测:littleornoevidence
suppress	抑制（表情）:inhibittheexpression;用暴力终止,镇压:putastopto,force
surcharge	过高收费:chargemuch
surfeit	（使）过量,（使）饮食过度:supplyexcess
surrender	交出,放弃,投降:giveoverto;使沉溺于:give（oneself）over
surreptitious	偷偷摸摸的,保密的:escapebeingobserved
susceptibility	易受感染的性质或状态:littleresistance
suspend	暂停,中止:bringtoaformalclose;悬挂:hang
suture	缝合:joining
svelte	（女人）体态苗条的,优雅的:slim
swagger	大摇大摆地走,趾高气昂地走:arrogant,pompous;自夸,吹嘘:boast
swear	咒骂:curse;宣誓:oath
sweltering	酷热的:hot
swerve	突然改变方向:turnasideabruptly
swill	痛饮,大口地吃:drinkgreedily,eatgreedily
swindle	欺骗,骗取:cheat
sybarite	沉溺于奢侈逸乐者,酒色之徒:devotedluxury
sycophant	马屁精:flatter
syllabus	提纲,摘要;课文、演讲或研究课题的概要或提纲:summary
syllogism	由一般到个别的推理,演绎:reasoning,deduction
symbiosis	共生关系:livingtogether
symmetry	对称:balancedproportions
synchronous	同时期的,同步的:identicalperiodphase
synergic	合作的:cooperating
synonymous	同义的:samesimilarmeaning
synopsis	摘要,概要:outline,abstract,summary
synthesis	合成,综合:combination
tacit	暗示的:implied,notactuallyexpressed
taciturn	沉默寡言的,话少的:disinclinedtotalk
tackle	着手处理:startwork
tact	机敏,精明,不冒犯:keensense,maintaingoodrelations
tactile	有触觉的,能触知的:touchtangible
tactless	不机智的,笨拙的:inconsiderate,indiscreet
talisman	护身符:bringgoodluck,keepawayevil
taint	使（品质）污损:morallybad
tamper	恶意篡改,损害:mischievously;玩弄:rashlyorfoolishly
tangent	离题（的）,不相关（的）:irrelevant
tangible	可感知的:capableperceived;确凿的,真实的:realorconcrete
tangy	刺激的:powerfullystimulating
tantalize	激起,挑逗,引诱:excite
tantamount	等价的,与...相等的:equivalent
tantrum	勃然大怒,发脾气:badtemper
taper	（使）逐渐变细:becomenarrower,thinner;逐渐减少,减弱:diminishgradually
tardy	缓慢的,迟缓的:slowly;延后的,迟的:delayed
tarnish	玷污:morallybad
tasty	美味的;令人愉悦的:pleasureorcontentment
tatty	破旧的,褴褛的:shabby
taunt	嘲弄性质疑,挑衅:challenge,jeerat
taut	紧绷的:notloose;整洁的:properorder,trimshape
tawdry	俗丽的,花哨而庸俗的:gaudy
taxing	繁重的,费力的:requiringmuchtime,effort
tedious	冗长乏味的:tiresome,dullness,boring
teeter	蹒跚,不稳定地行走:unsteadily;犹豫不决:uncertainty
telling	禁酒:abstinencealcoholic
temerity	有效的,显著的:effective
temporize	鲁莽,冒失:foolhardy,recklessness;行动躲躲闪闪以争取时间、躲避争论等:actevasively
temperate	（言行举止）有分寸的:avoidingextremes;有节制的:restraint
tempestuous	突然的,剧烈的:suddenorviolent
tenable	有据可依的,无懈可击的:capabledefended,reasonable
tenacious	顽固的,不屈不挠的:persistent;粘着的:adhereto
tendentious	有偏见的:biased
tender	正式提出:offer;考虑周到的,关心同情的:sympathyconsideration
tenuous	没有实际内容的,空洞的:littlesubstance
tepid	不太热心的:littleornointerest
terminology	专业术语:specialtermsorexpressions
terminus	终点,终点站:end
terror	极度恐惧:intensefear
terse	简洁的,简明的:brief
testimony	证词,声明:authentication
testy	易怒的,暴躁的:easilyannoyed,irritable
tether	（用绳、铁链）拴系、束缚:fasten,restrain;能力或忍耐力的极限:limit
theatrical	做作的,夸张的,矫揉造作的:exaggeratedunnatural
therapeutic	治疗的,有疗效的:treatmentdisease
thorny	多刺的:fullofthorns;棘手的:difficulties
threadbare	陈腐的:hackneyed;贫穷的:lackingpossessions;破烂的:wornortorn
throng	大量聚集:crowdingreatnumbers
thwart	阻挠:oppose
ticklish	易怒的:easilyoffended;棘手的,对技巧要求高的:exceptionalskillorcaution
tiff	小争吵:pettyquarrel
tightfisted	吝啬的:stingy
timeworn	陈腐的:hackneyed
timid	胆小的,不自信的lackingcourage,self-confidence
timorous	胆小的:fearful
tinge	给...着上少量的色彩:color,tint
tinker	乱修,乱调整:thoughtlessly
tint	涂浅色,微染:slightcolorationto
tirade	长篇抨击性演讲:angrycensoriousordenunciatory
toady	马屁精;拍马屁:flatters,gainingfavors
tonic	滋补的,有益健康的:stimulatingvigor,beneficial
topsy-turvy	混乱的:lackinginorder
torpid	麻木的,没有知觉的:sensation;迟钝的,行动迟缓的:slow
torpor	缺乏兴趣:lackofinterest;（肉体或精神上的）迟钝,懒散:inertness
torrential	急流的:rapidstreams
torrid	酷热的:intenselyhot;热情的,情感深厚的:greatdepthoffeeling
tortuous	转弯抹角的:indirect
tout	极力赞扬:praise
toy	草率或不认真地对待:handlethoughtlessly
tractable	易驾驭的,温顺的:givingin
tranquility	宁静,淡定:freedomfromstorm
transcend	超越,超过极限:beyondthelimits
transfigure	使改变外观:alterappearance,transform
transgress	违背,犯错:failtokeep,commitanoffense
transient	短暂的,瞬时的:transitory
transitory	短暂的:lastingonlyashorttime
translucent	透明的:permittingpassagelight,transparent
transparent	透明的:capableoftransmittinglight;没有歧义的,清晰易懂的:notsubjecttomisinterpretation
travail	辛苦劳动:arduous
traverse	横穿:passacross
travesty	拙劣的,嘲弄性模仿:exaggeratedimitation
treacherous	背叛的:betrayal
trenchant	锐利的:sharp;（言辞）一针见血的:articulate
trepidation	恐惧,战栗:apprehension
trespass	非法入侵;违反;冒犯:enterunlawfullyoffense
tribute	称颂,颂词:declarationgratitude
trickle	一滴一滴地流,缓缓地流:fallindrops
trite	陈腐的,陈词滥调的:hackneyed
trivial	琐碎的,无足轻重的:littleimportance
truant	逃避责任（的）;逃避责任者:shirkingresponsibility,shirksduty
truce	休战,休战协定:suspensionfighting
truculent	尖酸刻薄的:harshinsulting;好战的,好斗的:eagernesstofight
trudge	吃力而笨拙地走:heavilyorclumsily
trumpet	大声说出或宣告:makeknown
truncate	截短,缩短（时间、篇幅等）:shorten
truss	系紧,扎紧:intoatightmass
tumult	骚乱,暴动:disorderly,disturbance
turbid	混浊的:deficientinclarity
turbulent	动荡的:disturbance;湍急的,汹涌的:turmoil
turgid	浮夸的,过分装饰的:embellished
turmoil	骚动,混乱:agitation,commotion
turncoat	叛徒:switches,traitor
turpitude	卑鄙:baseness
twig	了解:haveaclearidea
typo	打字错误:error
tyro	新手,业余爱好者:beginner,novice
ubiquitous	无所不在的,普通的:everywhere,oftenobserved
unassailable	无可争辩的,无法否认的,不可亵渎的:nottobeviolated
uncanny	离奇的,奇异的:extraordinaryorabnormal
uncouth	粗俗的,没有品位的:lackinginrefinement
unctuous	油嘴滑舌的,谄媚的:flattering;夸张的,做作的:affected,exaggerated
underdog	受害者,输家:loser/victim
undergird	加强,巩固...的底部:strengthen
undermine	削弱,破坏:weaken,injure,impair
underscore	强调:toemphasize
understate	保守陈述:restraint
understudy	替补演员:takeanothersduties
unexceptionable	无懈可击的:beyondreproach
unflappable	镇定的,从容不迫的:noteasilyupset
ungainly	笨拙的,不雅的:inabilityinagracefulmanner
unimpeachable	无可置疑的:unquestionable
unkempt	凌乱的,无序的:lackinginorder
unlettered	未受教育的,文盲的:deficientintheknowledge,illiterate
unpretentious	低调的,谦逊的:modest;坦诚的,自然的:freefromdeceive
unproductive	徒然的,无效的:notproductive
unrequited	无报答的,无报酬的:notreciprocated
unruly	难驾驭的,不守规矩的:difficulttodiscipline
untenable	防守不住的,站不住脚的:defended
untold	数不清的,无数的:numerous
untoward	倒霉的,不吉利的:notfavorable,unpropitious;难以驯服的,难以驾驭的:resistingcontrolordiscipline
unwitting	不知道的,未觉察的:unware;偶然的,并非有意的:bychance,notintended
unwonted	不习惯的,不寻常的:nothabitual,ordinary,unusual
upbraid	（严厉地）谴责,责骂:reproachseverely
uphold	支持,赞成:support
urbane	彬彬有礼的,文雅的:polite
usurp	篡夺,篡位:seizepowerwithoutlegalauthority
utter	出（声）,说（话）:articulate;完全的,绝对的:entire
vaccinate	预防接种疫苗:produceimmunity
vacillate	犹豫不决:hesitate;摇动,摇摆:oscillate
vacuous	茫然的,愚蠢的:lackofintelligence
vagary	不可预测的思想或行为:erratic,unpredictable
vague	表达不清的:notclearlyexpressed;轮廓不清晰的:lackingdefiniteshape
valediction	告别:biddingfarewell;告别词:addressfarewell
valiant	勇敢的,英勇的:bravery
valid	逻辑上正确的:correct
vanquish	打败,征服:defeat
vapid	无趣的,乏味的:lackinginterest
vaporize	使（液体）蒸发:convertbyheat;彻底消灭:destroy
variance	不一致,不和谐:lackharmony
variegated	杂色的,斑驳的:differentcolors
varnish	上清漆,使有光泽:smoothglossy;粉饰（令人不悦的东西）:concealunpleasant
vault	跳起,跳跃:propeloneselfupward;一跃而至:leapingsuddenly
vaunt	吹嘘:boastfully
veer	（使）转向,（使）改变航线:changedirection
vehement	（情感）强烈的,热情的:greatdepthoffeeling
venal	贪污受贿的:opentocorrupt
vendor	小贩,商贩:sells
veneer	薄木板,用以贴在家具外面的饰面板:thinsurfacelayer,wood;粉饰（不好的东西）:concealdefect
venerate	尊敬:regardwithrespect
venial	可宽恕的:easilyexcused
venom	毒液:poisonousmatter;恶意,恶毒的用心:desiretocausepain
veracious	诚实的,说实话的:tellingthetruth;精确的,准确的:precise
verbatim	逐字地,一字不差地:exactwords
verbose	冗长的,啰嗦的:morethannecessary
verdant	（因长满植物而）翠绿的,郁郁葱葱的:greenwithvegetation
verify	校验,证实:determineaccuracy
verisimilar	貌似真实的:appearingtobetrue
veritable	真正的,确实的:notfalse
vernacular	方言:nonstandardlanguage;非正式的,口头的:suitableforspeech
versatile	多才多艺的,全能的:differentthings;易改变的:fluctuatingreadily
verse	使精通,使熟悉:familiarize;诗歌:rhythmlyricaleffect
vertigo	眩晕:dizzy
verve	活力,热情:vitality
vessel	管:tubebodyfluid;船,舰艇:watercraft
vestige	微小的痕迹;小痕迹:smallesttrace
vestigial	退化的,发育不全的:simplestructure
veteran	老兵;有丰富经验的人:knowledgethroughlongexperience;经验丰富的,资深的:knowledge,experience
veto	否决,禁止:forbid,prohibit
vex	使烦恼,使恼怒:bringagitation
viable	可行的:beingdone
vicarious	代理的,取代的:substituteforanother
vicious	凶恶的,恶毒的:desiretoinflict;猛烈的:violenceorferocity
vicissitude	自然变化,变迁兴衰:naturalchange
victimize	使受骗:subjecttodeception
vigilant	警醒的,警惕的:alertlywatchful
vignette	简介,短文:vividrepresentation
vigorous	精力旺盛的:activestrength;强健的:withstandhardship
vilify	诽谤,辱骂:utterslanderousstatements
vim	活力,精力:energy
vindicate	为...平反,为...辩护,使无罪:freefromblame;证明,证实:giveevidence
vindictive	复仇的,有寻仇倾向的:seekrevenge
virtuoso	艺术鉴赏家,专家:masterlyskill;经验丰富的,技艺精湛的:exceptionalknowledge
virtuous	品德高尚的,正直的:showingmoralexcellence
virulent	有毒的:poisonous;凶残的:destructivecourse
viscid	有粘性的:glutinous
viscous	粘稠的,粘的:viscid
visionary	空想的,不切实际的:guidedbyideals;幻觉的:intheimagination;有远见的:foresight
vitality	活力,生命力:vigor
vitiate	削弱,损害:reducethevalue;（在道德、审美上）降低,堕落:debaseinmoral
vitriolic	（言辞）刻薄的:scathing
vituperate	谩骂,责骂:abuseorcensure
vivacious	活泼的,快活的:lively
vociferous	喧哗的,大叫大嚷的:vehementoutcry
volatile	多变的:rapidchange
volition	意志,自愿选择的行为:makingonesownchoices
voluble	健谈的,多话的:readyspeech
voluminous	卷数多的,大量的,庞大的:greatnumber
voluptuous	奢侈逸乐的,沉湎酒色的:enjoymentsluxury
voracious	有很大食量的,贪吃的:hugeappetite;贪婪的,如饥似渴的:insatiable
votary	崇拜者,信徒:ferventlydevoted
vouch	担保,声称为真:giveaguarantee
vulgar	粗俗的,无教养的:crude;口头的,非正式的:suitableforspeech
vulnerable	易受攻击的,脆弱的:opentoattack
waddle	摇摇摆摆地走:tiltthebodyfromsidetoside
waffle	胡扯:talkfoolishly
waft	飘荡,漂浮:float
wag	诙谐幽默的人:humorous;摆动:movetoandfroorupanddown
wan	苍白的,病态的:poorhealth
wanderlust	旅游癖:impulsetotravel
wane	减少,衰退,降低:decrease
want	短缺:lacking;渴望:desire
warmonger	好战者:urgeswar
warp	使偏向:turn;扭曲,变形:twist;曲解:alterthemeaning
warrant	向...保证质量:assumeresponsibilityforthesatisfactoryquality;批准,认可:giveofficialacceptance
wary	小心的,机警的,谨慎的:caution
wastrel	肆意挥霍的人,败家子:expendsself-indulgently
watershed	重要关头,分水岭:turningpoint
wax	月亮渐满:increaseinphaseofthemoon;用蜡涂、处理或上光:coat;增大,增强:increase
waylay	埋伏,伏击:attack
welter	混乱,动乱:disorder
wheedle	（用花言巧语）诱惑,哄骗:persuadebyflattery
whet	磨快:sharpen
whiff	微风:slightgust;细微的信号,轻微痕迹:imperceptiblesign
whimsical	反复无常的:suddenillogicalchanges
wholesome	有益身心健康的:promotinghealth
wicked	邪恶的:morallybad
wince	畏缩:shrinkbackfrompain
windbag	健谈的人:talkative
windy	冗长的:verbosity
winsome	迷人的,漂亮的:pleasingandengaging
wit	机智,智慧:abilitytounderstand;智者,有智慧的人:intelligence
withdraw	撤退:takeback
wither	枯萎,凋谢:becomesapless
withhold	抑制;扣压,不给予:refrainfromgiving
wizen	（使）凋谢,（使）枯萎:becomewrinkled;凋谢的,枯萎的:driedup
wobble	摇晃,颤抖:moveorproceedunsteadily;犹豫不决:showuncertainty
worldly	世间的,世俗的:ratherthanspiritual;老练的:experienced
worship	崇拜,敬仰:respect;崇拜,膜拜:offerhonororrespect
wrangle	纷争,争端:differingopinions;争吵:quarrel
wretched	极差的:poorinquality;沮丧的:dejected
wry	扭曲的:twisted,bent;坚持错误的:stubborntowrong
xenophobe	仇视（或畏惧）外国人（或外国事物）者:fearfulofwhatisforeign
yoke	连接:becomejoined
yokel	乡下人,天真纯朴的人:inhabitantofaruralarea
zeal	热心,热诚:enthusiasticdevotion
zealot	狂热者:afanaticalpartisan
zenith	最高点,巅峰:culminating
zesty	刺激的,开胃的:piquant
abreast	并排地:inline;熟知的:knowledgeofrecentdevelopments
absent	未出现的,缺乏的:notpresent;不专心的,走神的:lostinthought
acclaim	称赞:publicacknowledgmentoradmiration;赞扬,赞颂:approval
accomplish	实现,完成:completion
accord	一致:consistency;相符合,相一致:inharmony;授予,给予:tograntorgive
acknowledge	承认:admit
acquire	获取,获得:getasonesown
acquisitive	贪婪的:desirous
adjudicate	裁决,判定:settle
adversity	厄运,逆境:difficulty
affectation	虚伪,做作:notnatural,notgenuinelyfelt
affirm	声称...为真,肯定...属实:validorconfirmed
affix	粘合:attachphysically
affliction	痛苦,悲伤,折磨:greatsuffering
agape	急切盼望的:eagerlyawaiting
agility	（身手）敏捷:quickness,easeandgrace
*agonize	折磨,使痛苦:agony;感到痛苦:sufferagony
agreeable	令人愉悦的:pleasingtothemindorsenses;随和的:easygoingandpleasingmanner;相一致:inharmony
*alienate	使...疏远:unfriendly,hostile,indifferent;转让,让渡:conveyortransfer
alloy	合金;混合物:combingoftwoormoredifferentthings;掺杂,降低...的纯度:debasebytheaddition
ambivalent	（尤指感情、态度）矛盾的:opposingfeelings
anachronistic	时代错误:chronologicallymisplaced
analogous	相似的,可比较的:incommon
annex	裙楼,副楼:auxiliarybuilding;添加,合并:join;吞并,夺取（土地等）:incorporate
annotate	给...作注解:commentaryorexplanatorynotes
antedate	比...早,早于:earlierdate
antipathy	厌恶,反感:aversion,dislike;令人反感的事物:objectionofaversion
antiquated	古老的,过时的:outofstyle
antithetical	完全对立的,相反的:directandunequivocalopposition
apparition	鬼魂,幽灵:ghostlyfigure
applicable	可用的,可行的:puttouse;相关的,有光的:havingtodowith;合适的,恰当的:meetingtherequirements
apprehensive	知晓的,理解的:impressedonthemind;恐惧的,害怕的:anxious,fearful
arable	适合耕作的:growingofcrops
arbitrary	专横的,独断专行的:forceoneswillonothers;独裁的,拥有无限权力的:withoutinterferencebyothers;缺乏计划的,随意的:lackingadefiniteplan
arcane	（语言）晦涩的,隐晦的:veiled,uncertain;深奥的,难以理解的:difficulttounderstand
argument	争吵,争论:expressionofdifferingopinions;（逻辑上的）论证:fromapremisetoaconclusion;观点,论点:idea,opinion
arid	干燥的:littleornoprecipitation;无趣的,无聊的:lackofinterest
array	排列,阵列:arrangement;排列,摆放:arrangeordisplay;装饰,装修:dressordecorate
assail	抨击,严厉批评:criticizeharshly;攻击,猛攻:violentactionagainst
asymmetry	不对称,不均衡:lackofbalance
atrophy	萎缩,衰退:wasteaway
attest	证实,为...作证:giveevidence
attune	使协调,使和谐:intoharmony
august	威严的,严重的:formalandseriousorreservedmanner;盛大的,令人印象深刻的:largeandimpressive
auspicious	好兆头的:towardahappyoutcome
austere	朴素的,朴实无华的:simple;严肃的,令人生畏的:sternandcold
automatic	（机器等）自动的:independentofexternalinfluence;自发的,情不自禁的:spontaneouslyorunconsciously
avowal	承认,公开宣称:declaration
backfire	产生相反的结果,事与愿违:reverse
backslide	（情况等）倒退,故态复萌:reverttoaworsecondition
baffle	挫败,阻挠:frustrateorcheck;使疑惑:mentaluncertainty
baffling	令人疑惑的,难以理解的:hardtocomprehend
bash	猛击:forcefulblow;攻击,用力击打:strikeviolently;抨击,严厉批评:criticizeharshly
bask	休息,悠然自得:lieorrelax
beholden	欠他人人情的:owinggratitude
behoove	对...有利:necessary,proper,advantageous
beige	缺乏特征的:lackingdistinction
belligerence	好斗,好战:aggressiveortruculent
belligerent	好斗的,好战的:assertiveness,hostility,combativeness
beset	使苦恼,骚扰:causepersistentsuffering;攻击,袭击:setupon
bewitching	迷人的,令人着迷的:attract
blackmail	敲诈,勒索:extortionofmoney
bluff	直率的,（说话）直截了当的:direct,brief,potentiallyrude;欺骗:deceive
bogus	伪造的,假冒的:beingsuchinappearanceonly;虚伪的,做作的:lacking,spontaneousquality
bore	令人讨厌的人或事物:causesboredom;使厌倦,使厌烦:makeweary
brandish	（带有威胁性地）挥舞:shakemenacingly
brim	边缘,边界:outermargin;充满:fulloftentooverflowing;加满,倒满:asmuchascanbe
bumble	含糊不清地说,杂乱无章地说:rapidly,inarticulately;笨拙地行动:clumsily
bustle	忙乱,喧嚣:noisy,energetic;（快速地）行走,奔忙:movebriskly
cachet*	威望,声望:markorquality
calamity	大灾难:disastrousevent
calculated	经过计算（成败得失）的,经过深思熟虑的:reckoningorestimating
calibrate*	校准,调校:check,adjust,determine
canny	精明的,聪明的:carefulandshrewed
canonize	过分宠爱,过分崇拜:admiretoomuch;使崇高,使神圣:highstatusorvalue
captious	吹毛求疵的,爱挑毛病的:stressfaultsandraiseobjections
careen	蹒跚而行.不稳定行走:tolurchorswerve;狂奔,快速运动:rush
carefree	无忧无虑的:noworriesortroubles
cascade	（尤指小的）瀑布:smallfall
cellular	多孔的:porous
ceremonious	讲究礼节的,庄重的:carefulattentiontosetforms
certitude	确定无疑:certain
channel	水渠:passagewayforwater;海峡:betweentwolandmasses;将...导入,投入:movetoacentralpoint
chaperone	同行,护送:goalongwith
charisma	魅力,吸引力:charm
cherished	受喜爱的,珍爱的:grantedspecialtreatment
chivalrous	有骑士风度的,（尤指对女性）彬彬有礼的:graciouscourtesyandhigh-mindedconsideration
chorale	赞美诗:hymnorpsalm;合唱班,合唱团:groupofsingers
clamor	喧闹;喧哗,噪声:loud,inharmonious
clan	（有共同爱好的）团体,帮派:unitedbyacommoninterest
cleave	紧贴,坚持:adhere;分隔,割裂,劈开:divide
cling	粘结,粘合:physicalsticking;紧贴;坚持:adhere
coarse	粗糙的,表面不平整的:notsmooth;（声音）刺耳的,粗声粗气的:roughintone;粗俗的:lackingrefinement;（质量）低劣的:inferiorquality
cohesive	有粘性的;有凝聚力的:cohesionorcoherence
collaborate	合作:workjointly
commiserate	表示怜悯,同情:sympathy
compatible	一致的,能共存的:inharmony
compelling	极具说服力的:persuade;迫切的,紧迫的:immediateattention
complacent	自满的,自鸣得意的:excessiveorunjustifiedsatisfaction;无所谓的,不关心的:lackofinterestorconcern
complementary	互补的:supplyingeachothers
complicate	使复杂化:complexordifficult
comprehend	理解,了解:grasp;包括,包含:containorholdwithin
concrete	实体的,实在的:matter;事实性的,明确的:infact
condemn	谴责（...为不道德的、邪恶的）:declaretobereprehensible,wrong,orevil
conditional	有条件的,受制约的:dependent
conflagration	大火:largedestructivefire;武装冲突:armedviolentstruggle
conflate	混合:turnintoasinglemass
conform	使协调:bringintoharmony;调整（以适应）:changetomakeitsuitable;遵照,遵从:obedient,compliant
conjure	请求,恳求:entreatearnestly;在脑海中浮现,想起:formamentalpicture
consent	同意:approval
consign	转交,转移（给他人）:controlofanother
consternation	惊愕,恐慌,恐惧:paralyzingdismay
constrict	压缩,压紧:bindingorsqueezing
contemplate	沉思,仔细考虑:consider
contempt	蔑视,鄙视:unworthyofonesconcernorrespect
contend	竞争,争夺:striveorvieincontest;声明,声称:stateasafact
contradict	否认,反驳;与...相矛盾:contrary
contrived	不自然的,刻意的:lackingspontaneousquality
convene	召开,召集:bringtogetherinassembly;聚集,集合:cometogether
correlate	使...相关联:mutualorreciprocalrelation
counterpart	（地位、功能）对等的人或物:samefunctionorcharacteristics
counterproductive	反效果的,阻碍预期目标的:notproducingdesiredgoal
courteous	礼貌的,谦恭有礼的:polishedmanners
coy	故作羞涩的:flirtatiouslyshyormodest;不愿与人交往的,内向的:tendingtoavoidpeople
credible	可信,值得信赖的:worthyofbeingaccepted
credit	信任,信赖:mentalconvictionofthetruth;表扬,赞扬:acknowledgmentoradmiration
crow	感到高兴:joyortriumph;自鸣得意:prideinonesownpossessions
damn	（在道德上）谴责:morallywrongorevil;非常地,极其地:greatdegree
dampen	（特指稍稍地）弄湿:wet;抑制,压抑（感情、精力等）,泼冷水:diminishthefeeling,activityorvigor
dashing	爱好冒险的,大胆的:takerisks
dated	过时的:passeditstimeofuse
deadlock	僵局:astateofinactionorneutralization;使陷入僵局,使停顿:toadeadlock
debonair	无忧无虑,不在乎的:freedomfromworriesortroubles;风度翩翩的:polishedandworldlymanners
decadent	堕落的,腐败的:loweredmoralcharacter;放纵的人:devotedtoluxuryandsensualpleasures;道德上堕落的人:moraldecay
decry	强烈反对,否定:strongdisapproval
deflect	使偏斜,使转向:turnasidefromastraightcourse
defray	支付:undertakethepayment
deign	（不情愿地）屈尊,俯就:condescendreluctantly
delegate	代理人,代表:representativeforanother;移交（权力,任务等）:possessionorsafekeepingofanother
delineate	勾勒,用线条描绘:bydrawnorpaintedlines;描写,描绘:describe,portray
demote	降职,降级:alowergrade
dependable	可靠的,值得信赖的:dependedon
deplorable	可鄙的,可耻的:condemnationorreproach;悲惨的,可悲的:causegreatdistress
desperate	绝望的:nohope
dichotomy	一分为二,分割:divisionintotwo
dictate	指令,命令:command;（仗着地位,权力）下令:request
dike	堤坝,水坝:controlorconfinewater;水沟,水渠:longnarrowchannel
discreet	（言行）谨慎的:goodjudgmentandrestraint;不易察觉的:notreadilyseenornoticed
disenchant	使清醒:freefromillusion
dishearten	使沮丧,使失去信心:losespiritormorale
disjunctive*	分离的:breaksordisunity
disprove	反驳,证明为假:provetobefalse
distinctive	完全不同的:notofthesamekind;特征性的,典型的:servingtoidentify
doctrinaire	教条主义的,照本宣科的:stronglyheldopinions
domineer	专制统治:overbearingcontrol
drab	单调的,无聊的:dullnessandmonotony
dramatic	显著的,惹人注意的:striking
dread	恐惧:fear
duplicate	复制品:exactlyalike;复制:makeacopy;重复,反复:dooveroragain
dynamic	有力量的,有活力的:productiveactivity
eclectic	混合的,多元化的:fromvarioussources
efficacious	有效的:produceadesiredeffect
elude	躲闪,躲避:avoidadroitly;使无法理解,使困惑:escapetheperception
enamored	迷恋的,热爱的:intenseorexcessivelove
endeavor	努力,奋斗:conscientiousorconcertedeffort;努力做,拼搏:devoteseriousandsustainedeffort
enthrall	（像用魔咒般）吸引:holdtheattention
equilibrium	均势,平衡:opposingforcesareequal;（感情上的）平静:evennessofemotions
erroneous	错误的,不正确的:containingerror
escort	护卫队,护送者:accompanyinganother;同行,护送:goalongwith
ethos	道德准则:codeofgoodconduct
exorcise	除去:gerridof
explicate	解释,说明:detailedexplanation
exterminate	根除,消灭:killingoff
extrapolate	（通过逻辑）判断:formanopinionthroughreasoning
fabulous	传说中的:fable;幻想中的,不真实的:intheimagination;令人惊讶的,令人称奇的:causingwonder;极好的:extremelypleasing
fad	（短暂的）流行,时尚:popularforashorttime
fallible	可能出错的:erroneous
fanciful	幻想中的:不真实的:intheimagination;不切实际的,荒谬的:withoutregardforreason
favoritism	偏爱,偏袒:specialfavor
featureless	缺乏特征的:lackingdistinguishingcharacteristics
feisty	好斗的,好争论的:aggressiveness
felony	重罪:gravecrimes
ferocious	极端的,剧烈的:unrelentingintensify;激烈的,爆发性的:burstsofdestructiveforce;凶猛的,残暴的:unfriendlyoraggressive
fervent	充满感情的,热情洋溢的:greatintensityoffeeling
figment	虚构的事物,幻觉:madeup
fitful	无规律的,缺乏周期的:erraticorintermittent
fleeting	稍纵即逝的,短暂的:forshorttime
forage	寻找:search
forebode	预示,预兆:showsigns
foreground	强调,重视:indicatetheimportance
forfeit	罚金:punishment
forsake	彻底放弃,抛弃:renounce
frosty	寒冷的:lowtemperature;无强烈情感的,冷淡的:lackinginfriendlinessorwarmth
gawky	（举止）笨拙的:inabilitytomoveinagracefulmanner
germinate	发芽:begintogrow;出现:comeintobeing
glacial	极冷的:extremelycold;冷漠的,无感情的:devoidofwarmth
glide	轻松地行动,轻松地通过:smoothly,continuously,effortlessly
glower	怒目而视:starewithanger
graft	移植,移接:implantsurgically
grit	（面对困难时所表现出来的）毅力:endurepainorhardship
groggy	虚弱的,（走路）不稳的:weakandunsteady;无法思考的,头脑不清的:notabletothinkormove
grudge	怨恨,仇恨:illwill
grumble	（尤指低声地）抱怨,埋怨:complain
halfhearted	不感兴趣的,不热情的:lackingheart
heckle	起哄,使难堪:harass
hierarchical	分等级的,等级制的:classified
hobble	跛行,蹒跚而行:haltinglyorwithdifficulty;阻碍,妨碍:hampertheaction
humdrum	千篇一律,单调:lackofvariety;无聊的,乏味的:lackingexcitement
humiliate	羞辱,使丧失尊严:toalowerposition
hypothetical	假设,前提条件:startingpoint;假定的:assumptionspeculation
idiosyncrasy	独特而奇怪的习惯:oddorpeculiarhabit
idle	闲置的,未使用的:notturnedtouse;懒散的:lazy;懒散度日,无所事事:withoutworking
ill-bred	没有教养的,没有礼貌的:impolite
illustrious	著名的,杰出的:distinguished
imperishable	不能被摧毁的:impossibletodestroy;不朽的,永恒的:occurringforever
implicit	不言而喻的,心照不宣的:understoodthoughunexpressed;无疑问的,无保留的:withoutdoubt
impostor*	冒名顶替者,骗子:assumesfalseidentity
impunity	免责,免受处罚:freedomfrompunishment
incentive	刺激,诱因:incites
incumbent	义不容辞的,必须的:obligationduty
indecorous	不合礼节的,不得体的:conflictingwithacceptedstandards
infraction	违背,违反:failuretoupholdtherequirements
justify	证明...的合理性,为...辩解:provetobejust,right
lag	最终的,最后的:followingallothers;缓慢行走:slowness;萎靡,失去活力:losebodilystrength
lance	长矛,标枪:longstraighthandleandsharpheadorblade;刺穿,刺破:penetrate
lax	松弛的,不紧的,不严格的:nottense,firm,orrigid;懈怠的,漫不经心的:failingtogivepropercare
license	许可,认可:approval;自由:movefreely;放荡:disregardforstandards;准许,授权使用:permitorauthorize
lionize	追捧,把...捧为名人:celebrity
ludicrous	荒唐的,可笑的:derisivelaughter
luminous	发光的,有光泽的:emittingorreflectinglight;杰出的:standingabove
lurid	恐怖的:令人反感的:causingrevulsion;面色苍白的,病态的:paleinappearance
machination	轨迹:schemingorcraftyaction
madcap	热爱冒险的人:seeksourverydangerousorfoolhardyadventures;大胆的,鲁莽的:foolishlyadventurousorbold
magnitude	重要,重大:greatnessinsignificance;巨大:greatnessinsize
malevolent	恶意的,恶毒的:viciousillwill,spite,hatred
malignant	恶毒的,邪恶的:desiretocausesomeonepain
maneuver	巧妙地操纵:guidewithadroitnessanddesign
marginal	边缘的:nearaborder;不重要的:notofcentralimportance
meditate	思索,沉思:focus
menial	仆人,奴仆:servant;卑贱的,低下的:spiritofhumilityorunseemlysubmissiveness
meretricious	艳俗的,俗气的:vulgarmanner
milieu	环境,氛围:physicalorsocialsetting
military	军事的,军用的:soldiers,arms,orwar
misapprehension	错误的理解、判断:failuretounderstand;wrongjudgment
monarch	君主,帝王:rules;巨头,大亨:personofrank,power,orinfluence
monopolize	垄断,主宰:completecontrol
nirvana	彻底放松的状态:disregardfulorunconscious;天堂,极乐世界:utterperfectionandhappiness
nostalgia	思乡之情:homesick;怀旧,怀念:sentimentalyearningforreturn
notoriety	（尤指因为丑闻而出名的）名人:widelyknownsomethingbad;坏名声:illfame
nourish	养育,培养:providewithfood;培养,促进:helpwithgrowth
novice	新手,初学者:new
nullification	（尤指法律条文等正式的）废除,废弃:doingaway
numb	失去感觉的:devoidofsensation;麻木的,无感情的:devoidofemotion
oaf	愚蠢的人:stupidperson
observant	警惕的,警觉的:payingcloseattention;严格遵守（规章、制度或原则）的:observing
obsolete	过时的,被淘汰的:nolongeruseful
onset	攻击,进攻:attack,assault;起始,开始:begins
ordeal	严峻的考验:severetrial
ostensible	表面上的,佯装的:appearingtobetrue
outgrowth	结果,后果:traceabletoacause
outmoded	过时的,废弃的:nolongerusable
override	不顾:setaside
overshadow	使变黯淡:makedark,dim;（在重要性上）超越,超过:exceedinimportance
overwhelm	淹没:cover;（感情上、精神上）使无所适从,使难以忍受:subjecttomentalstress
overwrought	十分激动的,非常不安的:agitation;（装饰、文风等）过分华丽的:excessivelydecorated
palaver	对话,交流:exchangeofviews;闲聊:profuselyoridly
palpitation	（有节奏的）舒张收缩:expandingandcontracting
panacea	万能药,万灵药:remedyforallills
peculiarity	特征,特点:distinguishingcharacteristic
pedagogical	教学的;教师的:teacheroreducation
peel	剥去...的皮:stripoff;脱去（衣服等）:takeoffclothes
perceptive	敏锐的:senseslightdifferences;洞察力强的:deepunderstanding
perilous	危险的:potentiallossorinjury
perquisite	额外的好处:giveninaddition
petulant	易怒的,爱发脾气的:easilyirritated
pioneer	扩荒者,先驱者:firsttosettle;最初的,最早的:comingbefore;开创,创造:openup
pious	（信仰上）虔诚的:devotiontodivineworship;忠诚的:firminonesallegiance
pitfall	陷阱:captureandholdanimals;（不易察觉的）危害:hiddendanger
pivotal	最关键的,最为重要的:greatestpossibleimportance
placid	宁静的,风平浪静的:freefromstorms;冷静的,淡定的:freefromagitation
playful	爱开玩笑的,好打闹的:jokingorteasing
plebeian	平民的,社会下层:lowsocialoreconomicrank
plentitude*	丰富,充沛:morethansufficient;大量:considerableamount
plodder	行走缓慢的人:movesslowly
plush	（味道等）浓郁的:abundancequality;奢华的,豪华的:notablyluxurious
poach	水煮:cookinaliquid
pointer	（仪表上的）指针:scaleindicator;忠告,建议:suggestionorhint
pragmatic	实用主义的,务实的:practicalapproach
premeditate*	预谋:thinkaboutbeforehand
prerequisite	先决条件,前提:necessarytoanend
prerogative	特权,权力:right,power,privilege
proclaim	宣告,使...公之于众:declarepublicly
project	方案,计划:specificplan;凸出:extendoutward;预测,预计:basedonpresentdataortrends
proprietary	所有权:ownership;私营的:privatelyowned
prototype	原型:originalmodel
rampant	（植物）生长茂盛的:growingthickly;猖獗的,不受限制的:occurringwithoutrestraint
ravenous	食量大的,贪食的;贪婪的:hugeappetite
redeem	实践,履行（诺言等）:required;改过自新:makebetter
refreshing	令人身心振奋的,提神的:renewingeffect
remnant	残余,剩余物:leftover
renege	放弃,摒弃:formallyreject
replenish	补充:fillagain
replicate	复制,复刻:makeanexactlikeness;重复,反复:doagain
residual	剩余的,残存的:residue
restitution	补偿,赔偿:forsomeinjury
resurrect	使重生,使复苏:bringbacktolife
retentive	记性好的:retainknowledgeorinformation
retrieve	寻回,找回:getbackagain
reverberate	回荡,回响:continueorberepeatedsoundwaves
rhetorical	语言上的,文字上的:wordsorlanguage;言辞华丽（却往往无内涵）的:fancybutmeaningless
rigmarole	混乱而无意义的话:confusedormeaninglesstalk
ruthless	没有怜悯心的,残忍的:nopity
sacrosanct	极为神圣的,不可侵犯的:mostsacred
scourge	祸害:sourceofharm
screen	掩护物,屏障:shelters,protects,orhides;保护,使...免受攻击:driveattackaway;掩护,遮蔽:shutofffromview
scrimp	节俭:avoidwaste
scruple	（良心上的）不安:uneasyfeelingabouttherightness
secede	脱离,拖出（组织、团体、联盟等）:withdrawfromanorganization
sectarianism	宗派主义,顽固:adherenceprejudices
secular	世俗的,尘世的:worldlyortemporal
sequel	结果:result
shift	改变...的位置:changeposition;改变,变化:passfrom;交换:inreturn
shifty	（显得）狡诈的,（显得）欺诈的:deceitfulcharacter
simile	明喻:comparingtwounlikethings
skittish	容易受到惊吓的,胆小的:easilyfrightened;容易激动的:easilyexcited;善变的,多变的:likelytochange
sparing	节俭的,节约的:carefulrestraint;不足的,缺乏的:lessplentiful
splinter	尖细条,刺:sharp,slenderpiece;将...切成细条:breakintosharp,slenderpieces
splutter	急切而不清楚地说:hastilyandincoherently
squeamish	恶心的,晕船的:nausea
stasis	平衡,停滞:balance
staunch	忠诚的,坚定的:steadfastinloyalty
stereotype	成见,老套的理念:conventional,formulaic,andoversimplifiedopinion
stigmatize	使蒙上污名:disgracefulorignominious
substitute	取代者,替代品:takestheplaceofanother;取代,替代:taketheplaceof
succumb	屈服:yieldtosuperiorstrength;死亡:death
supersede	取代,替代:displace
surly	脾气不好的:churlishinmood
surmise	（根据不足的）推测,揣测:basedonscantlyevidence
surmount	战胜,获得胜利:achieveavictory
surpass	超越,强于:becomebetter;突破（界限、纪录等）:beyondthelimit
surrogate	替代品:takestheplace
surveillance	监视,监控:closeobservation
tame	被驯化的:reducedfromastateofnativewildness;无聊的,乏味的:lackingspirit;控制,抑制:keepfromexceeding
tangle	困惑,不解:perplexity;纠缠,使....纠结:inasnare
teeming	大量的:greatnumbers
temporal	世俗的,尘世的:earthlylife
tentative	暂时性的,尝试的:notfullydeveloped
thick-skinned	冷漠无情的,不顾他人感受的:unaffected
thrill	强烈的兴奋感,快感:pleasurablyintensestimulate;使兴奋,使激动:excitement
timely	及时的,无拖延的:withoutdelay;恰到好处的,合乎时宜的:appropriate
topsy-turvy*	混乱的,不整洁的:lackinginorder,neatness
trifle	不重要的事:littleimportanceorvalue;不正经地对待,玩弄:withoutseriousintent
trifling	细微的,不重要的:lackinginsignificance
tycoon	大亨,巨头:personofrank,power,influence
tyrant	暴君:oppressivelyorbrutally
umbrage	不悦,生气:feelingofbeingoffendedorresentful
unanimous	一致同意的:consentofall
unavailing	徒劳的,无果的:producingnoresults
unremitting	连续不断的:withoutanyinterruptions
versed	熟知的:havinginformation;精通的:exceptionalknowledge
vile	丑陋的:unpleasanttolookat;（道德上）可鄙的,卑鄙的:morallydespicable
vocation	职业:employed
vouchsafe	允诺,给予:grantinagraciousorcondescendingmanner
voyeur	窥淫狂:observingunsuspectingindividuals
wanting	未出现的,缺少的:notpresent;未达到要求的:notbeinguptostandards
wayward	刚愎自用的,不服管束的:followingonesowninclinations
weather	安全度过（危机等）,经受住:comethrough
willful	固执的,倔强的:self-willed;故意的:deliberately
willy-nilly	不论是否愿意地:desiredornot;无秩序的,随意的:withoutorder
wilt	（花、植物等）萎焉:limporflaccid;精神萎靡,憔悴:fatigueorexhaustion
wily	狡诈的,狡猾的:deceptivemeans
wiretap	偷听,窃听:getinformation
wistful	（带着忧伤而）渴望的,怀念的:yearningordesirewithmelancholy
wrest	拧,扭动:wringingortwistingmovements;辛苦地获得:gainwithdifficulty
wrongheaded	固执己见的,坚持（错误观点）的:stubborninadherence
